a	ɛ́j
a	ə
abandon	ə b á n d ə n
ability	ə b ɪ́ l ə t ɪj
able	ɛ́j b ə l
about	ə b áw t
above	ə b ʌ́ v
abroad	ə b r óː d
absolute	á b s ə l ʉw t
absolutely	á b s ə l ʉ́w t l ɪj
academic	á k ə d ɛ́ m ɪ k
accept	ə k s ɛ́ p t
acceptable	ə k s ɛ́ p t ə b ə l
access	á k s ɛ s
accident	á k s ɪ d ə n t
accommodation	ə k ɔ́ m ə d ɛ́j ʃ ə n
accompany	ə k ʌ́ m p ə n ɪj
account	ə k áw n t
accurate	á k j ə r ə t
accuse	ə k j ʉ́w z
achieve	ə tʃ ɪ́j v
achievement	ə tʃ ɪ́j v m ə n t
acknowledge	ə k n ɔ́ l ɪ dʒ
acquire	ə k w ɑ́j ə
across	ə k r ɔ́ s
act	á k t
action	á k ʃ ə n
active	á k t ɪ v
activity	a k t ɪ́ v ə t ɪj
actor	á k t ə
actress	á k t r ə s
actual	á k tʃ ʉw ə l
actually	á k tʃ ə l ɪj
ad	á d
adapt	ə d á p t
add	á d
addition	ə d ɪ́ ʃ ə n
additional	ə d ɪ́ ʃ ə n ə l
address	ə d r ɛ́ s
administration	ə d m ɪ́ n ɪ s t r ɛ́j ʃ ə n
admire	ə d m ɑ́j ə
admit	ə d m ɪ́ t
adopt	ə d ɔ́ p t
adult	á d ʌ l t
advance	ə d v ɑ́ː n s
advanced	ə d v ɑ́ː n s t
advantage	ə d v ɑ́ː n t ɪ dʒ
adventure	ə d v ɛ́ n tʃ ə
advertise	á d v ə t ɑj z
advertisement	ə d v ə́ː t ɪ s m ə n t
advertising	á d v ə t ɑj z ɪ ŋ
advice	ə d v ɑ́j s
advise	ə d v ɑ́j z
affair	ə f ɛ́ː
affect	ə f ɛ́ k t
afford	ə f óː d
afraid	ə f r ɛ́j d
after	ɑ́ː f t ə
afternoon	ɑ́ː f t ə n ʉ́w n
afterwards	ɑ́ː f t ə w ə d z
again	ə g ɛ́ n
against	ə g ɛ́ n s t
age	ɛ́j dʒ
aged	ɛ́j dʒ d
aged	ɛ́j dʒ ɪ d
agency	ɛ́j dʒ ə n s ɪj
agenda	ə dʒ ɛ́ n d ə
agent	ɛ́j dʒ ə n t
aggressive	ə g r ɛ́ s ɪ v
ago	ə g ə́w
agree	ə g r ɪ́j
agreement	ə g r ɪ́j m ə n t
ah	ɑ́ː
ahead	ə h ɛ́ d
aid	ɛ́j d
aim	ɛ́j m
air	ɛ́ː
aircraft	ɛ́ː k r ɑː f t
airline	ɛ́ː l ɑj n
airport	ɛ́ː p oː t
alarm	ə l ɑ́ː m
album	á l b ə m
alcohol	á l k ə h ɔ l
alcoholic	á l k ə h ɔ́ l ɪ k
alive	ə l ɑ́j v
all	óː l
allow	ə l áw
almost	óː l m əw s t
alone	ə l ə́w n
along	ə l ɔ́ ŋ
already	oː l r ɛ́ d ɪj
also	óː l s əw
alter	ɔ́ l t ə
alternative	ɔ l t ə́ː n ə t ɪ v
although	oː l ð ə́w
always	óː l w ɛj z
amazed	ə m ɛ́j z d
amazing	ə m ɛ́j z ɪ ŋ
ambition	a m b ɪ́ ʃ ə n
ambitious	a m b ɪ́ ʃ ə s
among	ə m ʌ́ ŋ
amount	ə m áw n t
an	á n
an	ə n
analyse	á n ə l ɑj z
analysis	ə n á l ə s ɪ s
ancient	ɛ́j n ʃ ə n t
and	á n d
and	ə n d
anger	á ŋ g ə
angle	á ŋ g ə l
angry	á ŋ g r ɪj
animal	á n ɪ m ə l
ankle	á ŋ k ə l
anniversary	á n ɪ v ə́ː s ə r ɪj
announce	ə n áw n s
announcement	ə n áw n s m ə n t
annoy	ə n ój
annoyed	ə n ój d
annoying	ə n ój ɪ ŋ
annual	á n j ʉw ə l
another	ə n ʌ́ ð ə
answer	ɑ́ː n s ə
anxious	á ŋ k ʃ ə s
any	ɛ́ n ɪj
anybody	ɛ́ n ɪj b ɔ d ɪj
anyone	ɛ́ n ɪj w ʌ n
anything	ɛ́ n ɪj θ ɪ ŋ
anyway	ɛ́ n ɪj w ɛj
anywhere	ɛ́ n ɪj w ɛː
apart	ə p ɑ́ː t
apartment	ə p ɑ́ː t m ə n t
apologize	ə p ɔ́ l ə dʒ ɑj z
app	á p
apparent	ə p á r ə n t
apparently	ə p á r ə n t l ɪj
appeal	ə p ɪ́j l
appear	ə p ɪ́ː
appearance	ə p ɪ́ː r ə n s
apple	á p ə l
application	á p l ɪ k ɛ́j ʃ ə n
apply	ə p l ɑ́j
appointment	ə p ój n t m ə n t
appreciate	ə p r ɪ́j ʃ ɪj ɛj t
approach	ə p r ə́w tʃ
appropriate	ə p r ə́w p r ɪj ɛj t
appropriate	ə p r ə́w p r ɪj ə t
approval	ə p r ʉ́w v ə l
approve	ə p r ʉ́w v
approximately	ə p r ɔ́ k s ɪ m ə t l ɪj
April	ɛ́j p r ɪ l
architect	ɑ́ː k ɪ t ɛ k t
architecture	ɑ́ː k ɪ t ɛ k tʃ ə
area	ɛ́ː r ɪj ə
argue	ɑ́ː g j ʉw
argument	ɑ́ː g j ə m ə n t
arise	ə r ɑ́j z
arm	ɑ́ː m
armed	ɑ́ː m d
arms	ɑ́ː m z
army	ɑ́ː m ɪj
around	ə r áw n d
arrange	ə r ɛ́j n dʒ
arrangement	ə r ɛ́j n dʒ m ə n t
arrest	ə r ɛ́ s t
arrival	ə r ɑ́j v ə l
arrive	ə r ɑ́j v
art	ɑ́ː t
article	ɑ́ː t ɪ k ə l
artificial	ɑ́ː t ɪ f ɪ́ ʃ ə l
artist	ɑ́ː t ɪ s t
artistic	ɑː t ɪ́ s t ɪ k
as	á z
as	ə z
ashamed	ə ʃ ɛ́j m d
ask	ɑ́ː s k
asleep	ə s l ɪ́j p
aspect	á s p ɛ k t
assess	ə s ɛ́ s
assessment	ə s ɛ́ s m ə n t
assignment	ə s ɑ́j n m ə n t
assist	ə s ɪ́ s t
assistant	ə s ɪ́ s t ə n t
associate	ə s ə́w ʃ ɪj ɛj t
associate	ə s ə́w ʃ ɪj ə t
associated	ə s ə́w ʃ ɪj ɛj t ɪ d
association	ə s ə́w s ɪj ɛ́j ʃ ə n
assume	ə s j ʉ́w m
at	á t
at	ə t
athlete	á θ l ɪj t
atmosphere	á t m ə s f ɪː
attach	ə t á tʃ
attack	ə t á k
attempt	ə t ɛ́ m p t
attend	ə t ɛ́ n d
attention	ə t ɛ́ n ʃ ə n
attitude	á t ɪ tʃ ʉw d
attract	ə t r á k t
attraction	ə t r á k ʃ ə n
attractive	ə t r á k t ɪ v
audience	óː d ɪj ə n s
August	óː g ə s t
aunt	ɑ́ː n t
author	óː θ ə
authority	oː θ ɔ́ r ə t ɪj
autumn	óː t ə m
available	ə v ɛ́j l ə b ə l
average	á v ə r ɪ dʒ
avoid	ə v ój d
award	ə w óː d
aware	ə w ɛ́ː
away	ə w ɛ́j
awful	óː f ə l
baby	b ɛ́j b ɪj
back	b á k
background	b á k g r aw n d
backwards	b á k w ə d z
bacteria	b a k t ɪ́ː r ɪj ə
bad	b á d
badly	b á d l ɪj
bag	b á g
bake	b ɛ́j k
balance	b á l ə n s
ball	b óː l
ban	b á n
banana	b ə n ɑ́ː n ə
band	b á n d
bank	b á ŋ k
bar	b ɑ́ː
barrier	b á r ɪj ə
base	b ɛ́j s
baseball	b ɛ́j s b oː l
based	b ɛ́j s t
basic	b ɛ́j s ɪ k
basically	b ɛ́j s ɪ k l ɪj
basis	b ɛ́j s ɪ s
basketball	b ɑ́ː s k ɪ t b oː l
bath	b ɑ́ː θ
bathroom	b ɑ́ː θ r ʉw m
battery	b á t ə r ɪj
battle	b á t ə l
be	b ɪ́j
beach	b ɪ́j tʃ
bean	b ɪ́j n
bear	b ɛ́ː
beat	b ɪ́j t
beautiful	b j ʉ́w t ɪ f ə l
beauty	b j ʉ́w t ɪj
because	b ɪ k ɔ́ z
because	b ɪ k ə z
become	b ə k ʌ́ m
bed	b ɛ́ d
bedroom	b ɛ́ d r ʉw m
bee	b ɪ́j
beef	b ɪ́j f
beer	b ɪ́ː
before	b ə f óː
beg	b ɛ́ g
begin	b ə g ɪ́ n
beginning	b ə g ɪ́ n ɪ ŋ
behave	b ə h ɛ́j v
behaviour	b ə h ɛ́j v j ə
behind	b ə h ɑ́j n d
being	b ɪ́j ɪ ŋ
belief	b ə l ɪ́j f
believe	b ə l ɪ́j v
bell	b ɛ́ l
belong	b ə l ɔ́ ŋ
below	b ə l ə́w
belt	b ɛ́ l t
bend	b ɛ́ n d
benefit	b ɛ́ n ɪ f ɪ t
bent	b ɛ́ n t
best	b ɛ́ s t
bet	b ɛ́ t
better	b ɛ́ t ə
between	b ə t w ɪ́j n
beyond	b ɪj ɔ́ n d
bicycle	b ɑ́j s ɪ k ə l
big	b ɪ́ g
bike	b ɑ́j k
bill	b ɪ́ l
billion	b ɪ́ l j ə n
bin	b ɪ́ n
biology	b ɑj ɔ́ l ə dʒ ɪj
bird	b ə́ː d
birth	b ə́ː θ
birthday	b ə́ː θ d ɛj
biscuit	b ɪ́ s k ɪ t
bit	b ɪ́ t
bite	b ɑ́j t
bitter	b ɪ́ t ə
black	b l á k
blame	b l ɛ́j m
blank	b l á ŋ k
blind	b l ɑ́j n d
block	b l ɔ́ k
blog	b l ɔ́ g
blonde	b l ɔ́ n d
blood	b l ʌ́ d
blow	b l ə́w
blue	b l ʉ́w
board	b óː d
boat	b ə́w t
body	b ɔ́ d ɪj
boil	b ój l
bomb	b ɔ́ m
bond	b ɔ́ n d
bone	b ə́w n
book	b ɵ́ k
boot	b ʉ́w t
border	b óː d ə
bored	b óː d
boring	b óː r ɪ ŋ
born	b óː n
borrow	b ɔ́ r əw
boss	b ɔ́ s
both	b ə́w θ
bother	b ɔ́ ð ə
bottle	b ɔ́ t ə l
bottom	b ɔ́ t ə m
bowl	b ə́w l
box	b ɔ́ k s
boy	b ój
boyfriend	b ój f r ɛ n d
brain	b r ɛ́j n
branch	b r ɑ́ː n tʃ
brand	b r á n d
brave	b r ɛ́j v
bread	b r ɛ́ d
break	b r ɛ́j k
breakfast	b r ɛ́ k f ə s t
breast	b r ɛ́ s t
breath	b r ɛ́ θ
breathe	b r ɪ́j ð
breathing	b r ɪ́j ð ɪ ŋ
bride	b r ɑ́j d
bridge	b r ɪ́ dʒ
brief	b r ɪ́j f
bright	b r ɑ́j t
brilliant	b r ɪ́ l j ə n t
bring	b r ɪ́ ŋ
broad	b r óː d
broadcast	b r óː d k ɑː s t
broken	b r ə́w k ə n
brother	b r ʌ́ ð ə
brown	b r áw n
brush	b r ʌ́ ʃ
bubble	b ʌ́ b ə l
budget	b ʌ́ dʒ ɪ t
build	b ɪ́ l d
building	b ɪ́ l d ɪ ŋ
bullet	b ɵ́ l ɪ t
bunch	b ʌ́ n tʃ
burn	b ə́ː n
bury	b ɛ́ r ɪj
bus	b ʌ́ s
bush	b ɵ́ ʃ
business	b ɪ́ z n ə s
businessman	b ɪ́ z n ə s m ə n
busy	b ɪ́ z ɪj
but	b ə t
but	b ʌ́ t
butter	b ʌ́ t ə
button	b ʌ́ t ə n
buy	b ɑ́j
by	b ɑ́j
bye	b ɑ́j
cable	k ɛ́j b ə l
cake	k ɛ́j k
calculate	k á l k j ə l ɛj t
call	k óː l
calm	k ɑ́ː m
camera	k á m r ə
camp	k á m p
campaign	k a m p ɛ́j n
camping	k á m p ɪ ŋ
campus	k á m p ə s
can	k á n
can	k ə n
cancel	k á n s ə l
cancer	k á n s ə
candidate	k á n d ɪ d ə t
cannot	k á n ɔ t
cap	k á p
capable	k ɛ́j p ə b ə l
capacity	k ə p á s ə t ɪj
capital	k á p ɪ t ə l
captain	k á p t ɪ n
capture	k á p tʃ ə
car	k ɑ́ː
card	k ɑ́ː d
care	k ɛ́ː
career	k ə r ɪ́ː
careful	k ɛ́ː f ə l
carefully	k ɛ́ː f ə l ɪj
careless	k ɛ́ː l ə s
carpet	k ɑ́ː p ɪ t
carrot	k á r ə t
carry	k á r ɪj
cartoon	k ɑː t ʉ́w n
case	k ɛ́j s
cash	k á ʃ
cast	k ɑ́ː s t
castle	k ɑ́ː s ə l
cat	k á t
catch	k á tʃ
category	k á t ɪ g ə r ɪj
cause	k óː z
CD	s ɪ́j d ɪ́j
ceiling	s ɪ́j l ɪ ŋ
celebrate	s ɛ́ l ɪ b r ɛj t
celebration	s ɛ́ l ɪ b r ɛ́j ʃ ə n
celebrity	s ɪ l ɛ́ b r ə t ɪj
cell	s ɛ́ l
cent	s ɛ́ n t
central	s ɛ́ n t r ə l
centre	s ɛ́ n t ə
century	s ɛ́ n tʃ ə r ɪj
ceremony	s ɛ́ r ɪ m ə n ɪj
certain	s ə́ː t ə n
certainly	s ə́ː t ə n l ɪj
chain	tʃ ɛ́j n
chair	tʃ ɛ́ː
chairman	tʃ ɛ́ː m ə n
challenge	tʃ á l ə n dʒ
champion	tʃ á m p ɪj ə n
chance	tʃ ɑ́ː n s
change	tʃ ɛ́j n dʒ
channel	tʃ á n ə l
chapter	tʃ á p t ə
character	k á r ə k t ə
characteristic	k á r ə k t ə r ɪ́ s t ɪ k
charge	tʃ ɑ́ː dʒ
charity	tʃ á r ə t ɪj
chart	tʃ ɑ́ː t
chat	tʃ á t
cheap	tʃ ɪ́j p
cheat	tʃ ɪ́j t
check	tʃ ɛ́ k
cheerful	tʃ ɪ́ː f ə l
cheese	tʃ ɪ́j z
chef	ʃ ɛ́ f
chemical	k ɛ́ m ɪ k ə l
chemistry	k ɛ́ m ɪ s t r ɪj
chest	tʃ ɛ́ s t
chicken	tʃ ɪ́ k ɪ n
chief	tʃ ɪ́j f
child	tʃ ɑ́j l d
childhood	tʃ ɑ́j l d h ɵ d
chip	tʃ ɪ́ p
chocolate	tʃ ɔ́ k l ə t
choice	tʃ ój s
choose	tʃ ʉ́w z
church	tʃ ə́ː tʃ
cigarette	s ɪ́ g ə r ɛ́ t
cinema	s ɪ́ n ə m ɑː
circle	s ə́ː k ə l
circumstance	s ə́ː k ə m s t a n s
cite	s ɑ́j t
citizen	s ɪ́ t ɪ z ə n
city	s ɪ́ t ɪj
civil	s ɪ́ v ə l
claim	k l ɛ́j m
class	k l ɑ́ː s
classic	k l á s ɪ k
classical	k l á s ɪ k ə l
classroom	k l ɑ́ː s r ʉw m
clause	k l óː z
clean	k l ɪ́j n
clear	k l ɪ́ː
clearly	k l ɪ́ː l ɪj
clever	k l ɛ́ v ə
click	k l ɪ́ k
client	k l ɑ́j ə n t
climate	k l ɑ́j m ə t
climb	k l ɑ́j m
clock	k l ɔ́ k
close	k l ə́w s
close	k l ə́w z
closed	k l ə́w z d
closely	k l ə́w s l ɪj
cloth	k l ɔ́ θ
clothes	k l ə́w ð z
clothing	k l ə́w ð ɪ ŋ
cloud	k l áw d
club	k l ʌ́ b
clue	k l ʉ́w
coach	k ə́w tʃ
coal	k ə́w l
coast	k ə́w s t
coat	k ə́w t
code	k ə́w d
coffee	k ɔ́ f ɪj
coin	k ój n
cold	k ə́w l d
collapse	k ə l á p s
colleague	k ɔ́ l ɪj g
collect	k ɔ́ l ɛ k t
collect	k ə l ɛ́ k t
collection	k ə l ɛ́ k ʃ ə n
college	k ɔ́ l ɪ dʒ
colour	k ʌ́ l ə
coloured	k ʌ́ l ə d
column	k ɔ́ l ə m
combination	k ɔ́ m b ɪ n ɛ́j ʃ ə n
combine	k ɔ́ m b ɑj n
combine	k ə m b ɑ́j n
come	k ʌ́ m
comedy	k ɔ́ m ə d ɪj
comfort	k ʌ́ m f ə t
comfortable	k ʌ́ m f t ə b ə l
command	k ə m ɑ́ː n d
comment	k ɔ́ m ɛ n t
commercial	k ə m ə́ː ʃ ə l
commission	k ə m ɪ́ ʃ ə n
commit	k ə m ɪ́ t
commitment	k ə m ɪ́ t m ə n t
committee	k ə m ɪ́ t ɪj
common	k ɔ́ m ə n
commonly	k ɔ́ m ə n l ɪj
communicate	k ə m j ʉ́w n ɪ k ɛj t
communication	k ə m j ʉ́w n ɪ k ɛ́j ʃ ə n
community	k ə m j ʉ́w n ə t ɪj
company	k ʌ́ m p ə n ɪj
compare	k ə m p ɛ́ː
comparison	k ə m p á r ɪ s ə n
compete	k ə m p ɪ́j t
competition	k ɔ́ m p ə t ɪ́ ʃ ə n
competitive	k ə m p ɛ́ t ə t ɪ v
competitor	k ə m p ɛ́ t ɪ t ə
complain	k ə m p l ɛ́j n
complaint	k ə m p l ɛ́j n t
complete	k ə m p l ɪ́j t
completely	k ə m p l ɪ́j t l ɪj
complex	k ɔ́ m p l ɛ k s
complicated	k ɔ́ m p l ɪ k ɛj t ɪ d
component	k ə m p ə́w n ə n t
computer	k ə m p j ʉ́w t ə
concentrate	k ɔ́ n s ə n t r ɛj t
concentration	k ɔ́ n s ə n t r ɛ́j ʃ ə n
concept	k ɔ́ n s ɛ p t
concern	k ə n s ə́ː n
concerned	k ə n s ə́ː n d
concert	k ɔ́ n s ə t
concert	k ə n s ə́ː t
conclude	k ə n k l ʉ́w d
conclusion	k ə n k l ʉ́w ʒ ə n
condition	k ə n d ɪ́ ʃ ə n
conduct	k ɔ́ n d ʌ k t
conduct	k ə n d ʌ́ k t
conference	k ɔ́ n f ə r ə n s
confidence	k ɔ́ n f ɪ d ə n s
confident	k ɔ́ n f ɪ d ə n t
confirm	k ə n f ə́ː m
conflict	k ɔ́ n f l ɪ k t
conflict	k ə n f l ɪ́ k t
confuse	k ə n f j ʉ́w z
confused	k ə n f j ʉ́w z d
confusing	k ə n f j ʉ́w z ɪ ŋ
connect	k ə n ɛ́ k t
connected	k ə n ɛ́ k t ɪ d
connection	k ə n ɛ́ k ʃ ə n
conscious	k ɔ́ n ʃ ə s
consequence	k ɔ́ n s ɪ k w ə n s
conservative	k ə n s ə́ː v ə t ɪ v
consider	k ə n s ɪ́ d ə
consideration	k ə n s ɪ́ d ə r ɛ́j ʃ ə n
consist	k ə n s ɪ́ s t
consistent	k ə n s ɪ́ s t ə n t
constant	k ɔ́ n s t ə n t
constantly	k ɔ́ n s t ə n t l ɪj
construct	k ɔ́ n s t r ʌ k t
construct	k ə n s t r ʌ́ k t
construction	k ə n s t r ʌ́ k ʃ ə n
consume	k ə n s j ʉ́w m
consumer	k ə n s j ʉ́w m ə
contact	k ɔ́ n t a k t
contain	k ə n t ɛ́j n
container	k ə n t ɛ́j n ə
contemporary	k ə n t ɛ́ m p r ə r ɪj
content	k ɔ́ n t ɛ n t
content	k ə n t ɛ́ n t
contest	k ɔ́ n t ɛ s t
contest	k ə n t ɛ́ s t
context	k ɔ́ n t ɛ k s t
continent	k ɔ́ n t ɪ n ə n t
continue	k ə n t ɪ́ n j ʉw
continuous	k ə n t ɪ́ n j ʉw ə s
contract	k ɔ́ n t r a k t
contract	k ə n t r á k t
contrast	k ɔ́ n t r ɑː s t
contrast	k ə n t r ɑ́ː s t
contribute	k ə n t r ɪ́ b j ʉw t
contribution	k ɔ́ n t r ɪ b j ʉ́w ʃ ə n
control	k ə n t r ə́w l
convenient	k ə n v ɪ́j n ɪj ə n t
conversation	k ɔ́ n v ə s ɛ́j ʃ ə n
convert	k ɔ́ n v əː t
convert	k ə n v ə́ː t
convince	k ə n v ɪ́ n s
convinced	k ə n v ɪ́ n s t
cook	k ɵ́ k
cooker	k ɵ́ k ə
cooking	k ɵ́ k ɪ ŋ
cool	k ʉ́w l
copy	k ɔ́ p ɪj
core	k óː
corner	k óː n ə
corporate	k óː p ə r ə t
correct	k ə r ɛ́ k t
correctly	k ə r ɛ́ k t l ɪj
cost	k ɔ́ s t
costume	k ɔ́ s tʃ ʉw m
cottage	k ɔ́ t ɪ dʒ
cotton	k ɔ́ t ə n
could	k ɵ́ d
could	k ə d
council	k áw n s ə l
count	k áw n t
country	k ʌ́ n t r ɪj
countryside	k ʌ́ n t r ɪj s ɑj d
county	k áw n t ɪj
couple	k ʌ́ p ə l
courage	k ʌ́ r ɪ dʒ
course	k óː s
court	k óː t
cousin	k ʌ́ z ə n
cover	k ʌ́ v ə
covered	k ʌ́ v ə d
cow	k áw
crash	k r á ʃ
crazy	k r ɛ́j z ɪj
cream	k r ɪ́j m
create	k r ɪj ɛ́j t
creation	k r ɪj ɛ́j ʃ ə n
creative	k r ɪj ɛ́j t ɪ v
creature	k r ɪ́j tʃ ə
credit	k r ɛ́ d ɪ t
crew	k r ʉ́w
crime	k r ɑ́j m
criminal	k r ɪ́ m ɪ n ə l
crisis	k r ɑ́j s ɪ s
criterion	k r ɑj t ɪ́ː r ɪj ə n
critic	k r ɪ́ t ɪ k
critical	k r ɪ́ t ɪ k ə l
criticism	k r ɪ́ t ɪ s ɪ z ə m
criticize	k r ɪ́ t ɪ s ɑj z
crop	k r ɔ́ p
cross	k r ɔ́ s
crowd	k r áw d
crowded	k r áw d ɪ d
crucial	k r ʉ́w ʃ ə l
cruel	k r ʉ́w ə l
cry	k r ɑ́j
cultural	k ʌ́ l tʃ ə r ə l
culture	k ʌ́ l tʃ ə
cup	k ʌ́ p
cupboard	k ʌ́ b ə d
cure	k j óː
curly	k ə́ː l ɪj
currency	k ʌ́ r ə n s ɪj
current	k ʌ́ r ə n t
currently	k ʌ́ r ə n t l ɪj
curtain	k ə́ː t ə n
curve	k ə́ː v
curved	k ə́ː v d
custom	k ʌ́ s t ə m
customer	k ʌ́ s t ə m ə
cut	k ʌ́ t
cycle	s ɑ́j k ə l
dad	d á d
daily	d ɛ́j l ɪj
damage	d á m ɪ dʒ
dance	d ɑ́ː n s
dancer	d ɑ́ː n s ə
dancing	d ɑ́ː n s ɪ ŋ
danger	d ɛ́j n dʒ ə
dangerous	d ɛ́j n dʒ ə r ə s
dark	d ɑ́ː k
data	d ɛ́j t ə
date	d ɛ́j t
daughter	d óː t ə
day	d ɛ́j
dead	d ɛ́ d
deal	d ɪ́j l
dear	d ɪ́ː
death	d ɛ́ θ
debate	d ə b ɛ́j t
debt	d ɛ́ t
decade	d ɛ́ k ɛj d
December	d ɪ s ɛ́ m b ə
decent	d ɪ́j s ə n t
decide	d ə s ɑ́j d
decision	d ɪ s ɪ́ ʒ ə n
declare	d ə k l ɛ́ː
decline	d ə k l ɑ́j n
decorate	d ɛ́ k ə r ɛj t
decoration	d ɛ́ k ə r ɛ́j ʃ ə n
decrease	d ɪ́j k r ɪj s
decrease	d ə k r ɪ́j s
deep	d ɪ́j p
deeply	d ɪ́j p l ɪj
defeat	d ə f ɪ́j t
defence	d ə f ɛ́ n s
defend	d ə f ɛ́ n d
define	d ə f ɑ́j n
definite	d ɛ́ f ɪ n ə t
definitely	d ɛ́ f ɪ n ə t l ɪj
definition	d ɛ́ f ɪ n ɪ́ ʃ ə n
degree	d ə g r ɪ́j
delay	d ə l ɛ́j
deliberate	d ə l ɪ́ b ə r ɛj t
deliberate	d ə l ɪ́ b ə r ə t
deliberately	d ə l ɪ́ b ə r ə t l ɪj
delicious	d ə l ɪ́ ʃ ə s
delight	d ə l ɑ́j t
delighted	d ə l ɑ́j t ɪ d
deliver	d ə l ɪ́ v ə
delivery	d ə l ɪ́ v ə r ɪj
demand	d ə m ɑ́ː n d
demonstrate	d ɛ́ m ə n s t r ɛj t
dentist	d ɛ́ n t ɪ s t
deny	d ə n ɑ́j
department	d ə p ɑ́ː t m ə n t
departure	d ə p ɑ́ː tʃ ə
depend	d ə p ɛ́ n d
depressed	d ə p r ɛ́ s t
depressing	d ə p r ɛ́ s ɪ ŋ
depth	d ɛ́ p θ
describe	d ə s k r ɑ́j b
description	d ə s k r ɪ́ p ʃ ə n
desert	d ɛ́ z ə t
desert	d ə z ə́ː t
deserve	d ə z ə́ː v
design	d ə z ɑ́j n
designer	d ə z ɑ́j n ə
desire	d ə z ɑ́j ə
desk	d ɛ́ s k
desperate	d ɛ́ s p r ə t
despite	d ə s p ɑ́j t
destination	d ɛ́ s t ɪ n ɛ́j ʃ ə n
destroy	d ə s t r ój
detail	d ɪ́j t ɛj l
detailed	d ɪ́j t ɛj l d
detect	d ə t ɛ́ k t
detective	d ə t ɛ́ k t ɪ v
determine	d ə t ə́ː m ə n
determined	d ə t ə́ː m ə n d
develop	d ə v ɛ́ l ə p
development	d ə v ɛ́ l ə p m ə n t
device	d ə v ɑ́j s
diagram	d ɑ́j ə g r a m
dialogue	d ɑ́j ə l ɔ g
diamond	d ɑ́j ə m ə n d
diary	d ɑ́j ə r ɪj
dictionary	d ɪ́ k ʃ ə n r ɪj
die	d ɑ́j
diet	d ɑ́j ə t
difference	d ɪ́ f r ə n s
different	d ɪ́ f r ə n t
differently	d ɪ́ f r ə n t l ɪj
difficult	d ɪ́ f ɪ k ə l t
difficulty	d ɪ́ f ɪ k ə l t ɪj
dig	d ɪ́ g
digital	d ɪ́ dʒ ɪ t ə l
dinner	d ɪ́ n ə
direct	d ɑj r ɛ́ k t
direction	d ɑj r ɛ́ k ʃ ə n
directly	d ɑj r ɛ́ k t l ɪj
director	d ɑj r ɛ́ k t ə
dirt	d ə́ː t
dirty	d ə́ː t ɪj
disadvantage	d ɪ́ s ə d v ɑ́ː n t ɪ dʒ
disagree	d ɪ́ s ə g r ɪ́j
disappear	d ɪ́ s ə p ɪ́ː
disappointed	d ɪ́ s ə p ój n t ɪ d
disappointing	d ɪ́ s ə p ój n t ɪ ŋ
disaster	d ɪ z ɑ́ː s t ə
disc	d ɪ́ s k
discipline	d ɪ́ s ə p l ɪ n
discount	d ɪ s k áw n t
discount	d ɪ́ s k aw n t
discover	d ɪ s k ʌ́ v ə
discovery	d ɪ s k ʌ́ v ə r ɪj
discuss	d ɪ s k ʌ́ s
discussion	d ɪ s k ʌ́ ʃ ə n
disease	d ɪ z ɪ́j z
dish	d ɪ́ ʃ
dishonest	d ɪ s ɔ́ n ɪ s t
disk	d ɪ́ s k
dislike	d ɪ s l ɑ́j k
dismiss	d ɪ s m ɪ́ s
display	d ɪ s p l ɛ́j
distance	d ɪ́ s t ə n s
distribute	d ɪ s t r ɪ́ b j ʉw t
distribution	d ɪ́ s t r ɪ b j ʉ́w ʃ ə n
district	d ɪ́ s t r ɪ k t
divide	d ɪ v ɑ́j d
division	d ɪ v ɪ́ ʒ ə n
divorced	d ɪ v óː s t
do	d ʉ́w
do	d ə
do	d ə́w
doctor	d ɔ́ k t ə
document	d ɔ́ k j ə m ɛ n t
document	d ɔ́ k j ə m ə n t
documentary	d ɔ́ k j ə m ɛ́ n t r ɪj
dog	d ɔ́ g
dollar	d ɔ́ l ə
domestic	d ə m ɛ́ s t ɪ k
dominate	d ɔ́ m ɪ n ɛj t
donate	d əw n ɛ́j t
door	d óː
double	d ʌ́ b ə l
doubt	d áw t
down	d áw n
download	d áw n l ə́w d
download	d áw n l əw d
downstairs	d áw n s t ɛ́ː z
downwards	d áw n w ə d z
dozen	d ʌ́ z ə n
draft	d r ɑ́ː f t
drag	d r á g
drama	d r ɑ́ː m ə
dramatic	d r ə m á t ɪ k
draw	d r óː
drawing	d r óː r ɪ ŋ
dream	d r ɪ́j m
dress	d r ɛ́ s
dressed	d r ɛ́ s t
drink	d r ɪ́ ŋ k
drive	d r ɑ́j v
driver	d r ɑ́j v ə
driving	d r ɑ́j v ɪ ŋ
drop	d r ɔ́ p
drug	d r ʌ́ g
drum	d r ʌ́ m
drunk	d r ʌ́ ŋ k
dry	d r ɑ́j
due	dʒ ʉ́w
during	dʒ ɵ́ː r ɪ ŋ
dust	d ʌ́ s t
duty	dʒ ʉ́w t ɪj
DVD	d ɪ́j v ɪj d ɪ́j
each	ɪ́j tʃ
ear	ɪ́ː
early	ə́ː l ɪj
earn	ə́ː n
earth	ə́ː θ
earthquake	ə́ː θ k w ɛj k
easily	ɪ́j z ɪ l ɪj
east	ɪ́j s t
eastern	ɪ́j s t ə n
easy	ɪ́j z ɪj
eat	ɪ́j t
economic	ɪ́j k ə n ɔ́ m ɪ k
economy	ɪ k ɔ́ n ə m ɪj
edge	ɛ́ dʒ
edit	ɛ́ d ɪ t
edition	ɪ d ɪ́ ʃ ə n
editor	ɛ́ d ɪ t ə
educate	ɛ́ dʒ ə k ɛj t
educated	ɛ́ dʒ ə k ɛj t ɪ d
education	ɛ́ dʒ ə k ɛ́j ʃ ə n
educational	ɛ́ dʒ ə k ɛ́j ʃ ə n ə l
effect	ɪ f ɛ́ k t
effective	ɪ f ɛ́ k t ɪ v
effectively	ɪ f ɛ́ k t ɪ v l ɪj
efficient	ɪ f ɪ́ ʃ ə n t
effort	ɛ́ f ə t
egg	ɛ́ g
eight	ɛ́j t
eighteen	ɛ́j t ɪ́j n
eighty	ɛ́j t ɪj
either	ɑ́j ð ə
elderly	ɛ́ l d ə l ɪj
elect	ɪ l ɛ́ k t
election	ɪ l ɛ́ k ʃ ə n
electric	ɪ l ɛ́ k t r ɪ k
electrical	ɪ l ɛ́ k t r ɪ k ə l
electricity	ɪ l ɛ́ k t r ɪ́ s ə t ɪj
electronic	ɛ́ l ɛ k t r ɔ́ n ɪ k
element	ɛ́ l ɪ m ə n t
elephant	ɛ́ l ɪ f ə n t
eleven	ɪ l ɛ́ v ə n
else	ɛ́ l s
elsewhere	ɛ́ l s w ɛ́ː
email	ɪ́j m ɛj l
embarrassed	ɪ m b á r ə s t
embarrassing	ɪ m b á r ə s ɪ ŋ
emerge	ɪ m ə́ː dʒ
emergency	ɪ m ə́ː dʒ ə n s ɪj
emotion	ɪ m ə́w ʃ ə n
emotional	ɪ m ə́w ʃ ə n ə l
emphasis	ɛ́ m f ə s ɪ s
emphasize	ɛ́ m f ə s ɑj z
employ	ɪ m p l ój
employee	ɛ́ m p l oj ɪ́j
employer	ɪ m p l ój ə
employment	ɪ m p l ój m ə n t
empty	ɛ́ m p t ɪj
enable	ɪ n ɛ́j b ə l
encounter	ɪ n k áw n t ə
encourage	ɪ n k ʌ́ r ɪ dʒ
end	ɛ́ n d
ending	ɛ́ n d ɪ ŋ
enemy	ɛ́ n ə m ɪj
energy	ɛ́ n ə dʒ ɪj
engage	ɪ n g ɛ́j dʒ
engaged	ɪ n g ɛ́j dʒ d
engine	ɛ́ n dʒ ɪ n
engineer	ɛ́ n dʒ ɪ n ɪ́ː
engineering	ɛ́ n dʒ ɪ n ɪ́ː r ɪ ŋ
enhance	ɪ n h ɑ́ː n s
enjoy	ɪ n dʒ ój
enormous	ɪ n óː m ə s
enough	ɪ n ʌ́ f
enquiry	ɪ n k w ɑ́j r ɪj
ensure	ɪ n ʃ óː
enter	ɛ́ n t ə
entertain	ɛ́ n t ə t ɛ́j n
entertainment	ɛ́ n t ə t ɛ́j n m ə n t
enthusiasm	ɪ n θ j ʉ́w z ɪj a z ə m
enthusiastic	ɪ n θ j ʉ́w z ɪj á s t ɪ k
entire	ɪ n t ɑ́j ə
entirely	ɪ n t ɑ́j ə l ɪj
entrance	ɛ́ n t r ə n s
entrance	ɪ n t r ɑ́ː n s
entry	ɛ́ n t r ɪj
environment	ɪ n v ɑ́j r ə n m ə n t
environmental	ɪ n v ɑ́j r ə n m ɛ́ n t ə l
episode	ɛ́ p ɪ s əw d
equal	ɪ́j k w ə l
equally	ɪ́j k w ə l ɪj
equipment	ɪ k w ɪ́ p m ə n t
error	ɛ́ r ə
escape	ɪ s k ɛ́j p
especially	ɪ s p ɛ́ ʃ ə l ɪj
essay	ɛ s ɛ́j
essay	ɛ́ s ɛj
essential	ɪ s ɛ́ n ʃ ə l
establish	ɪ s t á b l ɪ ʃ
estate	ɪ s t ɛ́j t
estimate	ɛ́ s t ɪ m ɛj t
estimate	ɛ́ s t ɪ m ə t
ethical	ɛ́ θ ɪ k ə l
euro	j ɵ́ː r əw
evaluate	ɪ v á l j ʉw ɛj t
even	ɪ́j v ə n
evening	ɪ́j v n ɪ ŋ
event	ɪ v ɛ́ n t
eventually	ɪ v ɛ́ n tʃ ʉw ə l ɪj
ever	ɛ́ v ə
every	ɛ́ v r ɪj
everybody	ɛ́ v r ɪj b ɔ d ɪj
everyday	ɛ́ v r ɪj d ɛj
everyone	ɛ́ v r ɪj w ʌ n
everything	ɛ́ v r ɪj θ ɪ ŋ
everywhere	ɛ́ v r ɪj w ɛː
evidence	ɛ́ v ɪ d ə n s
evil	ɪ́j v ə l
exact	ɪ g z á k t
exactly	ɪ g z á k t l ɪj
exam	ɪ g z á m
examination	ɪ g z á m ɪ n ɛ́j ʃ ə n
examine	ɪ g z á m ɪ n
example	ɪ g z ɑ́ː m p ə l
excellent	ɛ́ k s ə l ə n t
except	ɪ k s ɛ́ p t
exchange	ɪ k s tʃ ɛ́j n dʒ
excited	ɪ k s ɑ́j t ɪ d
excitement	ɪ k s ɑ́j t m ə n t
exciting	ɪ k s ɑ́j t ɪ ŋ
excuse	ɪ k s k j ʉ́w s
excuse	ɪ k s k j ʉ́w z
executive	ɪ g z ɛ́ k j ə t ɪ v
exercise	ɛ́ k s ə s ɑj z
exhibition	ɛ́ k s ɪ b ɪ́ ʃ ə n
exist	ɪ g z ɪ́ s t
existence	ɪ g z ɪ́ s t ə n s
expand	ɪ k s p á n d
expect	ɪ k s p ɛ́ k t
expectation	ɛ́ k s p ɛ k t ɛ́j ʃ ə n
expected	ɪ k s p ɛ́ k t ɪ d
expedition	ɛ́ k s p ɪ d ɪ́ ʃ ə n
expense	ɪ k s p ɛ́ n s
expensive	ɪ k s p ɛ́ n s ɪ v
experience	ɪ k s p ɪ́ː r ɪj ə n s
experienced	ɪ k s p ɪ́ː r ɪj ə n s t
experiment	ɪ k s p ɛ́ r ɪ m ə n t
expert	ɛ́ k s p əː t
explain	ɪ k s p l ɛ́j n
explanation	ɛ́ k s p l ə n ɛ́j ʃ ə n
explode	ɪ k s p l ə́w d
exploration	ɛ́ k s p l ə r ɛ́j ʃ ə n
explore	ɪ k s p l óː
explosion	ɪ k s p l ə́w ʒ ə n
export	ɛ́ k s p oː t
export	ɪ k s p óː t
expose	ɪ k s p ə́w z
express	ɪ k s p r ɛ́ s
expression	ɪ k s p r ɛ́ ʃ ə n
extend	ɪ k s t ɛ́ n d
extent	ɪ k s t ɛ́ n t
external	ɪ k s t ə́ː n ə l
extra	ɛ́ k s t r ə
extraordinary	ɪ k s t r óː d ə n r ɪj
extreme	ɪ k s t r ɪ́j m
extremely	ɪ k s t r ɪ́j m l ɪj
eye	ɑ́j
face	f ɛ́j s
facility	f ə s ɪ́ l ə t ɪj
fact	f á k t
factor	f á k t ə
factory	f á k t ə r ɪj
fail	f ɛ́j l
failure	f ɛ́j l j ə
fair	f ɛ́ː
fairly	f ɛ́ː l ɪj
faith	f ɛ́j θ
fall	f óː l
false	f ɔ́ l s
familiar	f ə m ɪ́ l j ə
family	f á m l ɪj
famous	f ɛ́j m ə s
fan	f á n
fancy	f á n s ɪj
fantastic	f a n t á s t ɪ k
far	f ɑ́ː
farm	f ɑ́ː m
farmer	f ɑ́ː m ə
farming	f ɑ́ː m ɪ ŋ
fascinating	f á s ɪ n ɛj t ɪ ŋ
fashion	f á ʃ ə n
fashionable	f á ʃ n ə b ə l
fast	f ɑ́ː s t
fasten	f ɑ́ː s ə n
fat	f á t
father	f ɑ́ː ð ə
fault	f ɔ́ l t
favour	f ɛ́j v ə
favourite	f ɛ́j v r ɪ t
fear	f ɪ́ː
feather	f ɛ́ ð ə
feature	f ɪ́j tʃ ə
February	f ɛ́ b j ə r ɪj
fee	f ɪ́j
feed	f ɪ́j d
feedback	f ɪ́j d b a k
feel	f ɪ́j l
feeling	f ɪ́j l ɪ ŋ
fellow	f ɛ́ l əw
female	f ɪ́j m ɛj l
fence	f ɛ́ n s
festival	f ɛ́ s t ɪ v ə l
few	f j ʉ́w
fiction	f ɪ́ k ʃ ə n
field	f ɪ́j l d
fifteen	f ɪ́ f t ɪ́j n
fifth	f ɪ́ f θ
fifty	f ɪ́ f t ɪj
fight	f ɑ́j t
fighting	f ɑ́j t ɪ ŋ
figure	f ɪ́ g ə
file	f ɑ́j l
fill	f ɪ́ l
film	f ɪ́ l m
final	f ɑ́j n ə l
finally	f ɑ́j n ə l ɪj
finance	f ɑ́j n a n s
financial	f ɑj n á n ʃ ə l
find	f ɑ́j n d
finding	f ɑ́j n d ɪ ŋ
fine	f ɑ́j n
finger	f ɪ́ ŋ g ə
finish	f ɪ́ n ɪ ʃ
fire	f ɑ́j ə
firm	f ə́ː m
first	f ə́ː s t
firstly	f ə́ː s t l ɪj
fish	f ɪ́ ʃ
fishing	f ɪ́ ʃ ɪ ŋ
fit	f ɪ́ t
fitness	f ɪ́ t n ə s
five	f ɑ́j v
fix	f ɪ́ k s
fixed	f ɪ́ k s t
flag	f l á g
flame	f l ɛ́j m
flash	f l á ʃ
flat	f l á t
flexible	f l ɛ́ k s ə b ə l
flight	f l ɑ́j t
float	f l ə́w t
flood	f l ʌ́ d
floor	f l óː
flour	f l áw ə
flow	f l ə́w
flower	f l áw ə
flu	f l ʉ́w
fly	f l ɑ́j
flying	f l ɑ́j ɪ ŋ
focus	f ə́w k ə s
fold	f ə́w l d
folding	f ə́w l d ɪ ŋ
folk	f ə́w k
follow	f ɔ́ l əw
following	f ɔ́ l əw ɪ ŋ
food	f ʉ́w d
foot	f ɵ́ t
football	f ɵ́ t b oː l
for	f óː
for	f ə
force	f óː s
foreign	f ɔ́ r ə n
forest	f ɔ́ r ɪ s t
forever	f ə r ɛ́ v ə
forget	f ə g ɛ́ t
forgive	f ə g ɪ́ v
fork	f óː k
form	f óː m
formal	f óː m ə l
former	f óː m ə
fortunately	f óː tʃ ə n ə t l ɪj
fortune	f óː tʃ ʉw n
forty	f óː t ɪj
forward	f óː w ə d
found	f áw n d
four	f óː
fourteen	f óː t ɪ́j n
fourth	f óː θ
frame	f r ɛ́j m
free	f r ɪ́j
freedom	f r ɪ́j d ə m
freeze	f r ɪ́j z
frequency	f r ɪ́j k w ə n s ɪj
frequently	f r ɪ́j k w ə n t l ɪj
fresh	f r ɛ́ ʃ
Friday	f r ɑ́j d ɛj
fridge	f r ɪ́ dʒ
friend	f r ɛ́ n d
friendly	f r ɛ́ n d l ɪj
friendship	f r ɛ́ n d ʃ ɪ p
frighten	f r ɑ́j t ə n
frightened	f r ɑ́j t ə n d
frightening	f r ɑ́j t n ɪ ŋ
frog	f r ɔ́ g
from	f r ɔ́ m
from	f r ə m
front	f r ʌ́ n t
frozen	f r ə́w z ə n
fruit	f r ʉ́w t
fry	f r ɑ́j
fuel	f j ʉ́w ə l
full	f ɵ́ l
fully	f ɵ́ l ɪj
fun	f ʌ́ n
function	f ʌ́ ŋ k ʃ ə n
fund	f ʌ́ n d
fundamental	f ʌ́ n d ə m ɛ́ n t ə l
funding	f ʌ́ n d ɪ ŋ
funny	f ʌ́ n ɪj
fur	f ə́ː
furniture	f ə́ː n ɪ tʃ ə
further	f ə́ː ð ə
furthermore	f ə́ː ð ə m óː
future	f j ʉ́w tʃ ə
gain	g ɛ́j n
gallery	g á l ə r ɪj
game	g ɛ́j m
gang	g á ŋ
gap	g á p
garage	g á r ɪ dʒ
garden	g ɑ́ː d ə n
gas	g á s
gate	g ɛ́j t
gather	g á ð ə
general	dʒ ɛ́ n r ə l
generally	dʒ ɛ́ n r ə l ɪj
generate	dʒ ɛ́ n ə r ɛj t
generation	dʒ ɛ́ n ə r ɛ́j ʃ ə n
generous	dʒ ɛ́ n ə r ə s
genre	ʒ ɔ́ n r ə
gentle	dʒ ɛ́ n t ə l
gentleman	dʒ ɛ́ n t ə l m ə n
geography	dʒ ɔ́ g r ə f ɪj
get	g ɛ́ t
ghost	g ə́w s t
giant	dʒ ɑ́j ə n t
gift	g ɪ́ f t
girl	g ə́ː l
girlfriend	g ə́ː l f r ɛ n d
give	g ɪ́ v
glad	g l á d
glass	g l ɑ́ː s
global	g l ə́w b ə l
glove	g l ʌ́ v
go	g ə́w
goal	g ə́w l
god	g ɔ́ d
gold	g ə́w l d
golf	g ɔ́ l f
good	g ɵ́ d
goodbye	g ɵ́ d b ɑ́j
goods	g ɵ́ d z
govern	g ʌ́ v ə n
government	g ʌ́ v ə n m ə n t
grab	g r á b
grade	g r ɛ́j d
gradually	g r á dʒ ʉw ə l ɪj
graduate	g r á dʒ ʉw ɛj t
graduate	g r á dʒ ʉw ə t
grain	g r ɛ́j n
grand	g r á n d
grandfather	g r á n f ɑː ð ə
grandmother	g r á n m ʌ ð ə
grandparent	g r á n p ɛː r ə n t
grant	g r ɑ́ː n t
grass	g r ɑ́ː s
grateful	g r ɛ́j t f ə l
great	g r ɛ́j t
green	g r ɪ́j n
greet	g r ɪ́j t
grey	g r ɛ́j
ground	g r áw n d
group	g r ʉ́w p
grow	g r ə́w
growth	g r ə́w θ
guarantee	g á r ə n t ɪ́j
guard	g ɑ́ː d
guess	g ɛ́ s
guest	g ɛ́ s t
guide	g ɑ́j d
guilty	g ɪ́ l t ɪj
guitar	g ɪ t ɑ́ː
gun	g ʌ́ n
guy	g ɑ́j
gym	dʒ ɪ́ m
habit	h á b ɪ t
hair	h ɛ́ː
half	h ɑ́ː f
hall	h óː l
hand	h á n d
handle	h á n d ə l
hang	h á ŋ
happen	h á p ə n
happily	h á p ɪ l ɪj
happiness	h á p ɪj n ə s
happy	h á p ɪj
hard	h ɑ́ː d
hardly	h ɑ́ː d l ɪj
harm	h ɑ́ː m
harmful	h ɑ́ː m f ə l
hat	h á t
hate	h ɛ́j t
have	h á v
have	h ə v
he	h ɪ́j
head	h ɛ́ d
headache	h ɛ́ d ɛj k
headline	h ɛ́ d l ɑj n
health	h ɛ́ l θ
healthy	h ɛ́ l θ ɪj
hear	h ɪ́ː
hearing	h ɪ́ː r ɪ ŋ
heart	h ɑ́ː t
heat	h ɪ́j t
heating	h ɪ́j t ɪ ŋ
heaven	h ɛ́ v ə n
heavily	h ɛ́ v ɪ l ɪj
heavy	h ɛ́ v ɪj
heel	h ɪ́j l
height	h ɑ́j t
helicopter	h ɛ́ l ɪ k ɔ p t ə
hell	h ɛ́ l
hello	h ɛ l ə́w
help	h ɛ́ l p
helpful	h ɛ́ l p f ə l
her	h ə
her	h ə́ː
here	h ɪ́ː
hero	h ɪ́ː r əw
hers	h ə́ː z
herself	h əː s ɛ́ l f
hesitate	h ɛ́ z ɪ t ɛj t
hey	h ɛ́j
hi	h ɑ́j
hide	h ɑ́j d
high	h ɑ́j
highlight	h ɑ́j l ɑj t
highly	h ɑ́j l ɪj
hill	h ɪ́ l
him	h ɪ m
him	h ɪ́ m
himself	h ɪ m s ɛ́ l f
hire	h ɑ́j ə
his	h ɪ z
his	h ɪ́ z
historic	h ɪ s t ɔ́ r ɪ k
historical	h ɪ s t ɔ́ r ɪ k ə l
history	h ɪ́ s t r ɪj
hit	h ɪ́ t
hobby	h ɔ́ b ɪj
hockey	h ɔ́ k ɪj
hold	h ə́w l d
hole	h ə́w l
holiday	h ɔ́ l ə d ɛj
hollow	h ɔ́ l əw
holy	h ə́w l ɪj
home	h ə́w m
homework	h ə́w m w əː k
honest	ɔ́ n ɪ s t
honour	ɔ́ n ə
hope	h ə́w p
horrible	h ɔ́ r ə b ə l
horror	h ɔ́ r ə
horse	h óː s
hospital	h ɔ́ s p ɪ t ə l
host	h ə́w s t
hot	h ɔ́ t
hotel	h əw t ɛ́ l
hour	áw ə
house	h áw s
house	h áw z
household	h áw s h əw l d
housing	h áw z ɪ ŋ
how	h áw
however	h aw ɛ́ v ə
huge	h j ʉ́w dʒ
human	h j ʉ́w m ə n
humorous	h j ʉ́w m ə r ə s
humour	h j ʉ́w m ə
hundred	h ʌ́ n d r ə d
hungry	h ʌ́ ŋ g r ɪj
hunt	h ʌ́ n t
hunting	h ʌ́ n t ɪ ŋ
hurricane	h ʌ́ r ɪ k ɛj n
hurry	h ʌ́ r ɪj
hurt	h ə́ː t
husband	h ʌ́ z b ə n d
I	ɑ́j
ice	ɑ́j s
idea	ɑj d ɪ́ː
ideal	ɑj d ɪ́j ə l
identify	ɑj d ɛ́ n t ɪ f ɑj
identity	ɑj d ɛ́ n t ə t ɪj
if	ɪ f
if	ɪ́ f
ignore	ɪ g n óː
ill	ɪ́ l
illegal	ɪ l ɪ́j g ə l
illness	ɪ́ l n ə s
illustrate	ɪ́ l ə s t r ɛj t
illustration	ɪ́ l ə s t r ɛ́j ʃ ə n
image	ɪ́ m ɪ dʒ
imaginary	ɪ m á dʒ ɪ n ə r ɪj
imagination	ɪ m á dʒ ɪ n ɛ́j ʃ ə n
imagine	ɪ m á dʒ ɪ n
immediate	ɪ m ɪ́j d ɪj ə t
immediately	ɪ m ɪ́j d ɪj ə t l ɪj
immigrant	ɪ́ m ɪ g r ə n t
impact	ɪ m p á k t
impact	ɪ́ m p a k t
impatient	ɪ m p ɛ́j ʃ ə n t
imply	ɪ m p l ɑ́j
import	ɪ m p óː t
import	ɪ́ m p oː t
importance	ɪ m p óː t ə n s
important	ɪ m p óː t ə n t
impose	ɪ m p ə́w z
impossible	ɪ m p ɔ́ s ə b ə l
impress	ɪ m p r ɛ́ s
impress	ɪ́ m p r ɛ s
impressed	ɪ m p r ɛ́ s t
impression	ɪ m p r ɛ́ ʃ ə n
impressive	ɪ m p r ɛ́ s ɪ v
improve	ɪ m p r ʉ́w v
improvement	ɪ m p r ʉ́w v m ə n t
in	ɪ n
in	ɪ́ n
inch	ɪ́ n tʃ
incident	ɪ́ n s ɪ d ə n t
include	ɪ n k l ʉ́w d
included	ɪ n k l ʉ́w d ɪ d
including	ɪ n k l ʉ́w d ɪ ŋ
income	ɪ́ ŋ k ʌ m
increase	ɪ n k r ɪ́j s
increase	ɪ́ ŋ k r ɪj s
increasingly	ɪ n k r ɪ́j s ɪ ŋ l ɪj
incredible	ɪ n k r ɛ́ d ə b ə l
incredibly	ɪ n k r ɛ́ d ə b l ɪj
indeed	ɪ n d ɪ́j d
independent	ɪ́ n d ɪ p ɛ́ n d ə n t
indicate	ɪ́ n d ɪ k ɛj t
indirect	ɪ́ n d ɪ r ɛ́ k t
individual	ɪ́ n d ɪ v ɪ́ dʒ ʉw ə l
indoor	ɪ́ n d oː
indoors	ɪ́ n d óː z
industrial	ɪ n d ʌ́ s t r ɪj ə l
industry	ɪ́ n d ə s t r ɪj
infection	ɪ n f ɛ́ k ʃ ə n
influence	ɪ́ n f l ʉw ə n s
inform	ɪ n f óː m
informal	ɪ n f óː m ə l
information	ɪ́ n f ə m ɛ́j ʃ ə n
ingredient	ɪ n g r ɪ́j d ɪj ə n t
initial	ɪ n ɪ́ ʃ ə l
initially	ɪ n ɪ́ ʃ ə l ɪj
initiative	ɪ n ɪ́ ʃ ə t ɪ v
injure	ɪ́ n dʒ ə
injured	ɪ́ n dʒ ə d
injury	ɪ́ n dʒ ə r ɪj
inner	ɪ́ n ə
innocent	ɪ́ n ə s ə n t
inquiry	ɪ n k w ɑ́j r ɪj
insect	ɪ́ n s ɛ k t
inside	ɪ n s ɑ́j d
insight	ɪ́ n s ɑj t
insist	ɪ n s ɪ́ s t
inspire	ɪ n s p ɑ́j ə
install	ɪ n s t óː l
instance	ɪ́ n s t ə n s
instead	ɪ n s t ɛ́ d
institute	ɪ́ n s t ɪ tʃ ʉw t
institution	ɪ́ n s t ɪ tʃ ʉ́w ʃ ə n
instruction	ɪ n s t r ʌ́ k ʃ ə n
instructor	ɪ n s t r ʌ́ k t ə
instrument	ɪ́ n s t r ə m ə n t
insurance	ɪ n ʃ óː r ə n s
intelligence	ɪ n t ɛ́ l ɪ dʒ ə n s
intelligent	ɪ n t ɛ́ l ɪ dʒ ə n t
intend	ɪ n t ɛ́ n d
intended	ɪ n t ɛ́ n d ɪ d
intense	ɪ n t ɛ́ n s
intention	ɪ n t ɛ́ n ʃ ə n
interest	ɪ́ n t r ɛ s t
interested	ɪ́ n t r ɛ s t ɪ d
interesting	ɪ́ n t r ɛ s t ɪ ŋ
internal	ɪ n t ə́ː n ə l
international	ɪ́ n t ə n á ʃ n ə l
internet	ɪ́ n t ə n ɛ t
interpret	ɪ n t ə́ː p r ɪ t
interrupt	ɪ́ n t ə r ʌ́ p t
interview	ɪ́ n t ə v j ʉw
into	ɪ́ n t ʉw
into	ɪ́ n t ə
introduce	ɪ́ n t r ə dʒ ʉ́w s
introduction	ɪ́ n t r ə d ʌ́ k ʃ ə n
invent	ɪ n v ɛ́ n t
invention	ɪ n v ɛ́ n ʃ ə n
invest	ɪ n v ɛ́ s t
investigate	ɪ n v ɛ́ s t ɪ g ɛj t
investigation	ɪ n v ɛ́ s t ɪ g ɛ́j ʃ ə n
investment	ɪ n v ɛ́ s t m ə n t
invitation	ɪ́ n v ɪ t ɛ́j ʃ ə n
invite	ɪ n v ɑ́j t
invite	ɪ́ n v ɑj t
involve	ɪ n v ɔ́ l v
involved	ɪ n v ɔ́ l v d
iron	ɑ́j ə n
island	ɑ́j l ə n d
issue	ɪ́ ʃ ʉw
item	ɑ́j t ə m
its	ɪ t s
its	ɪ́ t s
itself	ɪ t s ɛ́ l f
jacket	dʒ á k ɪ t
jam	dʒ á m
January	dʒ á n j ə r ɪj
jazz	dʒ á z
jeans	dʒ ɪ́j n z
jewellery	dʒ ʉ́w ə l r ɪj
job	dʒ ɔ́ b
join	dʒ ój n
joke	dʒ ə́w k
journal	dʒ ə́ː n ə l
journalist	dʒ ə́ː n ə l ɪ s t
journey	dʒ ə́ː n ɪj
joy	dʒ ój
judge	dʒ ʌ́ dʒ
judgement	dʒ ʌ́ dʒ m ə n t
juice	dʒ ʉ́w s
July	dʒ ə l ɑ́j
jump	dʒ ʌ́ m p
June	dʒ ʉ́w n
junior	dʒ ʉ́w n ɪj ə
just	dʒ ʌ́ s t
justice	dʒ ʌ́ s t ɪ s
justify	dʒ ʌ́ s t ɪ f ɑj
keen	k ɪ́j n
keep	k ɪ́j p
key	k ɪ́j
keyboard	k ɪ́j b oː d
kick	k ɪ́ k
kid	k ɪ́ d
kill	k ɪ́ l
killing	k ɪ́ l ɪ ŋ
kilometre	k ɪ l ɔ́ m ɪ t ə
kind	k ɑ́j n d
king	k ɪ́ ŋ
kiss	k ɪ́ s
kitchen	k ɪ́ tʃ ɪ n
knee	n ɪ́j
knife	n ɑ́j f
knock	n ɔ́ k
know	n ə́w
knowledge	n ɔ́ l ɪ dʒ
lab	l á b
label	l ɛ́j b ə l
laboratory	l ə b ɔ́ r ə t r ɪj
labour	l ɛ́j b ə
lack	l á k
lady	l ɛ́j d ɪj
lake	l ɛ́j k
lamp	l á m p
land	l á n d
landscape	l á n d s k ɛj p
language	l á ŋ g w ɪ dʒ
laptop	l á p t ɔ p
large	l ɑ́ː dʒ
largely	l ɑ́ː dʒ l ɪj
last	l ɑ́ː s t
late	l ɛ́j t
later	l ɛ́j t ə
latest	l ɛ́j t ə s t
laugh	l ɑ́ː f
laughter	l ɑ́ː f t ə
launch	l óː n tʃ
law	l óː
lawyer	l ój ə
lay	l ɛ́j
layer	l ɛ́j ə
lazy	l ɛ́j z ɪj
lead	l ɛ́ d
lead	l ɪ́j d
leader	l ɪ́j d ə
leadership	l ɪ́j d ə ʃ ɪ p
leading	l ɛ́ d ɪ ŋ
leading	l ɪ́j d ɪ ŋ
leaf	l ɪ́j f
league	l ɪ́j g
lean	l ɪ́j n
learn	l ə́ː n
learning	l ə́ː n ɪ ŋ
least	l ɪ́j s t
leather	l ɛ́ ð ə
leave	l ɪ́j v
lecture	l ɛ́ k tʃ ə
left	l ɛ́ f t
leg	l ɛ́ g
legal	l ɪ́j g ə l
leisure	l ɛ́ ʒ ə
lemon	l ɛ́ m ə n
lend	l ɛ́ n d
length	l ɛ́ ŋ k θ
less	l ɛ́ s
lesson	l ɛ́ s ə n
let	l ɛ́ t
letter	l ɛ́ t ə
level	l ɛ́ v ə l
library	l ɑ́j b r ə r ɪj
licence	l ɑ́j s ə n s
lie	l ɑ́j
life	l ɑ́j f
lifestyle	l ɑ́j f s t ɑj l
lift	l ɪ́ f t
light	l ɑ́j t
like	l ɑ́j k
likely	l ɑ́j k l ɪj
limit	l ɪ́ m ɪ t
limited	l ɪ́ m ɪ t ɪ d
line	l ɑ́j n
link	l ɪ́ ŋ k
lion	l ɑ́j ə n
lip	l ɪ́ p
liquid	l ɪ́ k w ɪ d
list	l ɪ́ s t
listen	l ɪ́ s ə n
listener	l ɪ́ s n ə
literature	l ɪ́ t r ə tʃ ə
little	l ɪ́ t ə l
live	l ɑ́j v
live	l ɪ́ v
lively	l ɑ́j v l ɪj
living	l ɪ́ v ɪ ŋ
load	l ə́w d
loan	l ə́w n
local	l ə́w k ə l
locate	l əw k ɛ́j t
located	l əw k ɛ́j t ɪ d
location	l əw k ɛ́j ʃ ə n
lock	l ɔ́ k
logical	l ɔ́ dʒ ɪ k ə l
lonely	l ə́w n l ɪj
long	l ɔ́ ŋ
long-term	l ɔ́ ŋ t əː m
look	l ɵ́ k
loose	l ʉ́w s
lord	l óː d
lorry	l ɔ́ r ɪj
lose	l ʉ́w z
loss	l ɔ́ s
lost	l ɔ́ s t
lot	l ɔ́ t
loud	l áw d
loudly	l áw d l ɪj
love	l ʌ́ v
lovely	l ʌ́ v l ɪj
low	l ə́w
lower	l áw ə
lower	l ə́w ə
luck	l ʌ́ k
lucky	l ʌ́ k ɪj
lunch	l ʌ́ n tʃ
lung	l ʌ́ ŋ
luxury	l ʌ́ k ʃ ə r ɪj
machine	m ə ʃ ɪ́j n
mad	m á d
magazine	m á g ə z ɪ́j n
magic	m á dʒ ɪ k
mail	m ɛ́j l
main	m ɛ́j n
mainly	m ɛ́j n l ɪj
maintain	m ɛj n t ɛ́j n
major	m ɛ́j dʒ ə
majority	m ə dʒ ɔ́ r ə t ɪj
make	m ɛ́j k
male	m ɛ́j l
mall	m óː l
man	m á n
manage	m á n ɪ dʒ
management	m á n ɪ dʒ m ə n t
manager	m á n ɪ dʒ ə
manner	m á n ə
many	m ɛ́ n ɪj
map	m á p
March	m ɑ́ː tʃ
mark	m ɑ́ː k
market	m ɑ́ː k ɪ t
marketing	m ɑ́ː k ɪ t ɪ ŋ
marriage	m á r ɪ dʒ
married	m á r ɪj d
marry	m á r ɪj
mass	m á s
massive	m á s ɪ v
master	m ɑ́ː s t ə
match	m á tʃ
matching	m á tʃ ɪ ŋ
material	m ə t ɪ́ː r ɪj ə l
mathematics	m á θ ə m á t ɪ k s
maths	m á θ s
matter	m á t ə
maximum	m á k s ɪ m ə m
May	m ɛ́j
maybe	m ɛ́j b ɪj
me	m ɪ́j
meal	m ɪ́j l
mean	m ɪ́j n
meaning	m ɪ́j n ɪ ŋ
means	m ɪ́j n z
meanwhile	m ɪ́j n w ɑj l
measure	m ɛ́ ʒ ə
measurement	m ɛ́ ʒ ə m ə n t
meat	m ɪ́j t
media	m ɪ́j d ɪj ə
medical	m ɛ́ d ɪ k ə l
medicine	m ɛ́ d ɪ s ə n
medium	m ɪ́j d ɪj ə m
meet	m ɪ́j t
meeting	m ɪ́j t ɪ ŋ
melt	m ɛ́ l t
member	m ɛ́ m b ə
memory	m ɛ́ m r ɪj
mental	m ɛ́ n t ə l
mention	m ɛ́ n ʃ ə n
menu	m ɛ́ n j ʉw
mess	m ɛ́ s
message	m ɛ́ s ɪ dʒ
metal	m ɛ́ t ə l
method	m ɛ́ θ ə d
metre	m ɪ́j t ə
middle	m ɪ́ d ə l
midnight	m ɪ́ d n ɑj t
might	m ɑ́j t
mild	m ɑ́j l d
mile	m ɑ́j l
military	m ɪ́ l ɪ t r ɪj
milk	m ɪ́ l k
million	m ɪ́ l j ə n
mind	m ɑ́j n d
mine	m ɑ́j n
mineral	m ɪ́ n ə r ə l
minimum	m ɪ́ n ɪ m ə m
minister	m ɪ́ n ɪ s t ə
minor	m ɑ́j n ə
minority	m ɑj n ɔ́ r ə t ɪj
minute	m ɑj n j ʉ́w t
minute	m ɪ́ n ɪ t
mirror	m ɪ́ r ə
miss	m ɪ́ s
missing	m ɪ́ s ɪ ŋ
mission	m ɪ́ ʃ ə n
mistake	m ɪ s t ɛ́j k
mix	m ɪ́ k s
mixed	m ɪ́ k s t
mixture	m ɪ́ k s tʃ ə
mobile	m ə́w b ɑj l
model	m ɔ́ d ə l
modern	m ɔ́ d ə n
modify	m ɔ́ d ɪ f ɑj
moment	m ə́w m ə n t
Monday	m ʌ́ n d ɛj
money	m ʌ́ n ɪj
monitor	m ɔ́ n ɪ t ə
monkey	m ʌ́ ŋ k ɪj
month	m ʌ́ n θ
mood	m ʉ́w d
moon	m ʉ́w n
moral	m ɔ́ r ə l
more	m óː
morning	m óː n ɪ ŋ
most	m ə́w s t
mostly	m ə́w s t l ɪj
mother	m ʌ́ ð ə
motor	m ə́w t ə
motorcycle	m ə́w t ə s ɑj k ə l
mount	m áw n t
mountain	m áw n t ɪ n
mouse	m áw s
mouth	m áw ð
mouth	m áw θ
move	m ʉ́w v
movement	m ʉ́w v m ə n t
movie	m ʉ́w v ɪj
much	m ʌ́ tʃ
mud	m ʌ́ d
multiple	m ʌ́ l t ɪ p ə l
multiply	m ʌ́ l t ɪ p l ɑj
mum	m ʌ́ m
murder	m ə́ː d ə
muscle	m ʌ́ s ə l
museum	m j ʉw z ɪ́j ə m
music	m j ʉ́w z ɪ k
musical	m j ʉ́w z ɪ k ə l
musician	m j ʉw z ɪ́ ʃ ə n
must	m ə s t
must	m ʌ́ s t
my	m ɑ́j
myself	m ɑj s ɛ́ l f
mysterious	m ɪ s t ɪ́ː r ɪj ə s
mystery	m ɪ́ s t r ɪj
nail	n ɛ́j l
name	n ɛ́j m
narrative	n á r ə t ɪ v
narrow	n á r əw
nation	n ɛ́j ʃ ə n
national	n á ʃ n ə l
native	n ɛ́j t ɪ v
natural	n á tʃ r ə l
naturally	n á tʃ r ə l ɪj
nature	n ɛ́j tʃ ə
near	n ɪ́ː
nearly	n ɪ́ː l ɪj
neat	n ɪ́j t
necessarily	n ɛ́ s ə s ɛ́ r ɪ l ɪj
necessary	n ɛ́ s ə s ɛ r ɪj
neck	n ɛ́ k
need	n ɪ́j d
needle	n ɪ́j d ə l
negative	n ɛ́ g ə t ɪ v
neighbour	n ɛ́j b ə
neighbourhood	n ɛ́j b ə h ɵ d
neither	n ɑ́j ð ə
nerve	n ə́ː v
nervous	n ə́ː v ə s
net	n ɛ́ t
network	n ɛ́ t w əː k
never	n ɛ́ v ə
nevertheless	n ɛ́ v ə ð ə l ɛ́ s
new	n j ʉ́w
news	n j ʉ́w z
newspaper	n j ʉ́w z p ɛj p ə
next	n ɛ́ k s t
nice	n ɑ́j s
night	n ɑ́j t
nightmare	n ɑ́j t m ɛː
nine	n ɑ́j n
nineteen	n ɑ́j n t ɪ́j n
ninety	n ɑ́j n t ɪj
no	n ʌ́ m b ə
no	n ə́w
nobody	n ə́w b ə d ɪj
noise	n ój z
noisy	n ój z ɪj
none	n ʌ́ n
nor	n óː
normal	n óː m ə l
normally	n óː m ə l ɪj
north	n óː θ
northern	n óː ð ə n
nose	n ə́w z
not	n ɔ́ t
note	n ə́w t
nothing	n ʌ́ θ ɪ ŋ
notice	n ə́w t ɪ s
notion	n ə́w ʃ ə n
novel	n ɔ́ v ə l
November	n əw v ɛ́ m b ə
now	n áw
nowhere	n ə́w w ɛː
nuclear	n j ʉ́w k l ɪj ə
number	n ʌ́ m b ə
numerous	n j ʉ́w m ə r ə s
nurse	n ə́ː s
nut	n ʌ́ t
obey	əw b ɛ́j
object	ɔ́ b dʒ ɛ k t
object	ə b dʒ ɛ́ k t
objective	ə b dʒ ɛ́ k t ɪ v
obligation	ɔ́ b l ɪ g ɛ́j ʃ ə n
observation	ɔ́ b z ə v ɛ́j ʃ ə n
observe	ə b z ə́ː v
obtain	ə b t ɛ́j n
obvious	ɔ́ b v ɪj ə s
obviously	ɔ́ b v ɪj ə s l ɪj
occasion	ə k ɛ́j ʒ ə n
occasionally	ə k ɛ́j ʒ ə n ə l ɪj
occur	ə k ə́ː
ocean	ə́w ʃ ə n
October	ɔ k t ə́w b ə
odd	ɔ́ d
of	ɔ́ v
of	ə v
off	ɔ́ f
offence	ə f ɛ́ n s
offend	ə f ɛ́ n d
offensive	ə f ɛ́ n s ɪ v
offer	ɔ́ f ə
office	ɔ́ f ɪ s
officer	ɔ́ f ɪ s ə
official	ə f ɪ́ ʃ ə l
often	ɔ́ f ə n
oh	ə́w
oil	ój l
OK	ə́w k ɛ́j
old	ə́w l d
old-fashioned	əw l f á ʃ ə n d
on	ɔ́ n
once	w ʌ́ n s
one	w ʌ́ n
onion	ʌ́ n j ə n
online	ɔ́ n l ɑ́j n
only	ə́w n l ɪj
onto	ɔ́ n t ə
open	ə́w p ə n
opening	ə́w p ə n ɪ ŋ
operate	ɔ́ p ə r ɛj t
operation	ɔ́ p ə r ɛ́j ʃ ə n
opinion	ə p ɪ́ n j ə n
opponent	ə p ə́w n ə n t
opportunity	ɔ́ p ə tʃ ʉ́w n ə t ɪj
oppose	ə p ə́w z
opposed	ə p ə́w z d
opposite	ɔ́ p ə z ɪ t
opposition	ɔ́ p ə z ɪ́ ʃ ə n
option	ɔ́ p ʃ ə n
or	óː
or	ə
orange	ɔ́ r ɪ n dʒ
order	óː d ə
ordinary	óː d ɪ n r ɪj
organ	óː g ə n
organization	óː g ə n ɑj z ɛ́j ʃ ə n
organize	óː g ə n ɑj z
organized	óː g ə n ɑj z d
organizer	óː g ə n ɑj z ə
origin	ɔ́ r ɪ dʒ ɪ n
original	ə r ɪ́ dʒ ə n ə l
originally	ə r ɪ́ dʒ ə n ə l ɪj
other	ʌ́ ð ə
otherwise	ʌ́ ð ə w ɑj z
ought	óː t
our	ɑ́ː
ours	ɑ́ː z
ourselves	áw ə s ɛ́ l v z
out	áw t
outcome	áw t k ʌ m
outdoor	áw t d oː
outdoors	áw t d óː z
outer	áw t ə
outline	áw t l ɑj n
outside	áw t s ɑ́j d
outside	áw t s ɑj d
oven	ʌ́ v ə n
over	ə́w v ə
overall	ə́w v ə r oː l
overall	ə́w v ə r óː l
owe	ə́w
own	ə́w n
owner	ə́w n ə
pace	p ɑ́ː tʃ ɛj
pace	p ɛ́j s
pack	p á k
package	p á k ɪ dʒ
page	p ɛ́j dʒ
pain	p ɛ́j n
painful	p ɛ́j n f ə l
paint	p ɛ́j n t
painter	p ɛ́j n t ə
painting	p ɛ́j n t ɪ ŋ
pair	p ɛ́ː
palace	p á l ɪ s
pale	p ɛ́j l
pan	p á n
panel	p á n ə l
pants	p á n t s
paper	p ɛ́j p ə
paragraph	p á r ə g r ɑː f
parent	p ɛ́ː r ə n t
park	p ɑ́ː k
parking	p ɑ́ː k ɪ ŋ
parliament	p ɑ́ː l ə m ə n t
part	p ɑ́ː t
participant	p ɑː t ɪ́ s ɪ p ə n t
participate	p ɑː t ɪ́ s ɪ p ɛj t
particular	p ə t ɪ́ k j ə l ə
particularly	p ə t ɪ́ k j ə l ə l ɪj
partly	p ɑ́ː t l ɪj
partner	p ɑ́ː t n ə
party	p ɑ́ː t ɪj
pass	p ɑ́ː s
passage	p á s ɪ dʒ
passenger	p á s ɪ n dʒ ə
passion	p á ʃ ə n
passport	p ɑ́ː s p oː t
past	p ɑ́ː s t
path	p ɑ́ː θ
patient	p ɛ́j ʃ ə n t
pattern	p á t ə n
pay	p ɛ́j
payment	p ɛ́j m ə n t
peace	p ɪ́j s
peaceful	p ɪ́j s f ə l
pen	p ɛ́ n
pencil	p ɛ́ n s ə l
penny	p ɛ́ n ɪj
pension	p ɛ́ n ʃ ə n
pension	p ɔ́ n s ɪj ɔ n
people	p ɪ́j p ə l
pepper	p ɛ́ p ə
per	p ə
per	p ə́ː
percentage	p ə s ɛ́ n t ɪ dʒ
perfect	p ə f ɛ́ k t
perfect	p ə́ː f ɪ k t
perfectly	p ə́ː f ɪ k t l ɪj
perform	p ə f óː m
performance	p ə f óː m ə n s
perhaps	p ə h á p s
period	p ɪ́ː r ɪj ə d
permanent	p ə́ː m ə n ə n t
permission	p ə m ɪ́ ʃ ə n
permit	p ə m ɪ́ t
permit	p ə́ː m ɪ t
person	p ə́ː s ə n
personal	p ə́ː s ə n ə l
personality	p ə́ː s ə n á l ə t ɪj
personally	p ə́ː s ə n ə l ɪj
perspective	p ə s p ɛ́ k t ɪ v
persuade	p ə s w ɛ́j d
pet	p ɛ́ t
petrol	p ɛ́ t r ə l
phase	f ɛ́j z
phenomenon	f ɪ n ɔ́ m ɪ n ə n
philosophy	f ɪ l ɔ́ s ə f ɪj
phone	f ə́w n
photo	f ə́w t əw
photograph	f ə́w t ə g r ɑː f
photographer	f ə t ɔ́ g r ə f ə
photography	f ə t ɔ́ g r ə f ɪj
phrase	f r ɛ́j z
physical	f ɪ́ z ɪ k ə l
physics	f ɪ́ z ɪ k s
piano	p ɪj ɑ́ː n əw
piano	p j á n əw
pick	p ɪ́ k
picture	p ɪ́ k tʃ ə
piece	p ɪ́j s
pig	p ɪ́ g
pile	p ɑ́j l
pilot	p ɑ́j l ə t
pin	p ɪ́ n
pink	p ɪ́ ŋ k
pipe	p ɑ́j p
pitch	p ɪ́ tʃ
place	p l ɛ́j s
plain	p l ɛ́j n
plan	p l á n
plane	p l ɛ́j n
planet	p l á n ɪ t
planning	p l á n ɪ ŋ
plant	p l ɑ́ː n t
plastic	p l á s t ɪ k
plate	p l ɛ́j t
platform	p l á t f oː m
play	p l ɛ́j
player	p l ɛ́j ə
pleasant	p l ɛ́ z ə n t
please	p l ɪ́j z
pleased	p l ɪ́j z d
pleasure	p l ɛ́ ʒ ə
plenty	p l ɛ́ n t ɪj
plot	p l ɔ́ t
plus	p l ʌ́ s
pocket	p ɔ́ k ɪ t
poem	p ə́w ɪ m
poet	p ə́w ɪ t
poetry	p ə́w ɪ t r ɪj
point	p ój n t
pointed	p ój n t ɪ d
poison	p ój z ə n
poisonous	p ój z ə n ə s
police	p ə l ɪ́j s
policeman	p ə l ɪ́j s m ə n
policy	p ɔ́ l ə s ɪj
polite	p ə l ɑ́j t
political	p ə l ɪ́ t ɪ k ə l
politician	p ɔ́ l ɪ t ɪ́ ʃ ə n
politics	p ɔ́ l ɪ t ɪ k s
pollution	p ə l ʉ́w ʃ ə n
pool	p ʉ́w l
poor	p óː
pop	p ɔ́ p
popular	p ɔ́ p j ə l ə
popularity	p ɔ́ p j ə l á r ə t ɪj
population	p ɔ́ p j ə l ɛ́j ʃ ə n
port	p óː t
portrait	p óː t r ɛj t
pose	p ə́w z
position	p ə z ɪ́ ʃ ə n
positive	p ɔ́ z ə t ɪ v
possess	p ə z ɛ́ s
possession	p ə z ɛ́ ʃ ə n
possibility	p ɔ́ s ə b ɪ́ l ə t ɪj
possible	p ɔ́ s ə b ə l
possibly	p ɔ́ s ə b l ɪj
post	p ə́w s t
poster	p ə́w s t ə
pot	p ɔ́ t
potato	p ə t ɛ́j t əw
potential	p ə t ɛ́ n ʃ ə l
pound	p áw n d
pour	p óː
poverty	p ɔ́ v ə t ɪj
powder	p áw d ə
power	p áw ə
powerful	p áw ə f ə l
practical	p r á k t ɪ k ə l
practice	p r á k t ɪ s
practise	p r á k t ɪ s
praise	p r ɛ́j z
pray	p r ɛ́j
prayer	p r ɛ́ː
predict	p r ɪ d ɪ́ k t
prediction	p r ɪ d ɪ́ k ʃ ə n
prefer	p r ɪ f ə́ː
pregnant	p r ɛ́ g n ə n t
preparation	p r ɛ́ p ə r ɛ́j ʃ ə n
prepare	p r ɪ p ɛ́ː
prepared	p r ɪ p ɛ́ː d
presence	p r ɛ́ z ə n s
present	p r ɛ́ z ə n t
present	p r ɪ z ɛ́ n t
presentation	p r ɛ́ z ə n t ɛ́j ʃ ə n
preserve	p r ɪ z ə́ː v
president	p r ɛ́ z ɪ d ə n t
press	p r ɛ́ s
pressure	p r ɛ́ ʃ ə
pretend	p r ɪ t ɛ́ n d
pretty	p r ɪ́ t ɪj
prevent	p r ɪ v ɛ́ n t
previous	p r ɪ́j v ɪj ə s
previously	p r ɪ́j v ɪj ə s l ɪj
price	p r ɑ́j s
priest	p r ɪ́j s t
primary	p r ɑ́j m ə r ɪj
prime	p r ɑ́j m
prince	p r ɪ́ n s
princess	p r ɪ́ n s ɛ́ s
principle	p r ɪ́ n s ə p ə l
print	p r ɪ́ n t
printer	p r ɪ́ n t ə
printing	p r ɪ́ n t ɪ ŋ
priority	p r ɑj ɔ́ r ə t ɪj
prison	p r ɪ́ z ə n
prisoner	p r ɪ́ z ə n ə
privacy	p r ɪ́ v ə s ɪj
private	p r ɑ́j v ɪ t
prize	p r ɑ́j z
probably	p r ɔ́ b ə b l ɪj
problem	p r ɔ́ b l ə m
procedure	p r ə s ɪ́j dʒ ə
process	p r ə s ɛ́ s
process	p r ə́w s ɛ s
produce	p r ɔ́ dʒ ʉw s
produce	p r ə dʒ ʉ́w s
producer	p r ə dʒ ʉ́w s ə
product	p r ɔ́ d ʌ k t
production	p r ə d ʌ́ k ʃ ə n
profession	p r ə f ɛ́ ʃ ə n
professional	p r ə f ɛ́ ʃ n ə l
professor	p r ə f ɛ́ s ə
profile	p r ə́w f ɑj l
profit	p r ɔ́ f ɪ t
program	p r ə́w g r a m
programme	p r ə́w g r a m
progress	p r ə g r ɛ́ s
progress	p r ə́w g r ɛ s
project	p r ɔ́ dʒ ɛ k t
project	p r ə dʒ ɛ́ k t
promise	p r ɔ́ m ɪ s
promote	p r ə m ə́w t
pronounce	p r ə n áw n s
proof	p r ʉ́w f
proper	p r ɔ́ p ə
properly	p r ɔ́ p ə l ɪj
property	p r ɔ́ p ə t ɪj
proposal	p r ə p ə́w z ə l
propose	p r ə p ə́w z
prospect	p r ɔ́ s p ɛ k t
prospect	p r ə s p ɛ́ k t
protect	p r ə t ɛ́ k t
protection	p r ə t ɛ́ k ʃ ə n
protest	p r ə t ɛ́ s t
protest	p r ə́w t ɛ s t
proud	p r áw d
prove	p r ʉ́w v
provide	p r ə v ɑ́j d
psychologist	s ɑj k ɔ́ l ə dʒ ɪ s t
psychology	s ɑj k ɔ́ l ə dʒ ɪj
pub	p ʌ́ b
public	p ʌ́ b l ɪ k
publication	p ʌ́ b l ɪ k ɛ́j ʃ ə n
publish	p ʌ́ b l ɪ ʃ
pull	p ɵ́ l
punish	p ʌ́ n ɪ ʃ
punishment	p ʌ́ n ɪ ʃ m ə n t
pupil	p j ʉ́w p ə l
purchase	p ə́ː tʃ ə s
pure	p j óː
purple	p ə́ː p ə l
purpose	p ə́ː p ə s
pursue	p ə s j ʉ́w
push	p ɵ́ ʃ
put	p ɵ́ t
put	p ʌ́ t
qualification	k w ɔ́ l ɪ f ɪ k ɛ́j ʃ ə n
qualified	k w ɔ́ l ɪ f ɑj d
qualify	k w ɔ́ l ɪ f ɑj
quality	k w ɔ́ l ə t ɪj
quantity	k w ɔ́ n t ə t ɪj
quarter	k w óː t ə
queen	k w ɪ́j n
question	k w ɛ́ s tʃ ə n
queue	k j ʉ́w
quick	k w ɪ́ k
quickly	k w ɪ́ k l ɪj
quiet	k w ɑ́j ə t
quietly	k w ɑ́j ə t l ɪj
quit	k w ɪ́ t
quite	k w ɑ́j t
quotation	k w əw t ɛ́j ʃ ə n
quote	k w ə́w t
race	r ɛ́j s
racing	r ɛ́j s ɪ ŋ
radio	r ɛ́j d ɪj əw
railway	r ɛ́j l w ɛj
rain	r ɛ́j n
raise	r ɛ́j z
range	r ɛ́j n dʒ
rank	r á ŋ k
rapid	r á p ɪ d
rapidly	r á p ɪ d l ɪj
rare	r ɛ́ː
rarely	r ɛ́ː l ɪj
rate	r ɛ́j t
rather	r ɑ́ː ð ə
raw	r óː
reach	r ɪ́j tʃ
react	r ɪj á k t
reaction	r ɪj á k ʃ ə n
read	r ɛ́ d
read	r ɪ́j d
reader	r ɪ́j d ə
reading	r ɪ́j d ɪ ŋ
ready	r ɛ́ d ɪj
real	r ɛj ɑ́ː l
real	r ɪ́j ə l
realistic	r ɪ́j ə l ɪ́ s t ɪ k
reality	r ɪj á l ə t ɪj
realize	r ɪ́j ə l ɑj z
really	r ɪ́ː l ɪj
reason	r ɪ́j z ə n
reasonable	r ɪ́j z n ə b ə l
recall	r ɪ k óː l
receipt	r ɪ s ɪ́j t
receive	r ɪ s ɪ́j v
recent	r ɪ́j s ə n t
recently	r ɪ́j s ə n t l ɪj
reception	r ɪ s ɛ́ p ʃ ə n
recipe	r ɛ́ s ə p ɪj
recognize	r ɛ́ k ə g n ɑj z
recommend	r ɛ́ k ə m ɛ́ n d
recommendation	r ɛ́ k ə m ɛ n d ɛ́j ʃ ə n
record	r ɛ́ k oː d
record	r ɪ k óː d
recording	r ɪ k óː d ɪ ŋ
recover	r ɪ k ʌ́ v ə
recycle	r ɪ́j s ɑ́j k ə l
red	r ɛ́ d
reduce	r ɪ dʒ ʉ́w s
reduction	r ɪ d ʌ́ k ʃ ə n
refer	r ɪ f ə́ː
reference	r ɛ́ f r ə n s
reflect	r ɪ f l ɛ́ k t
refuse	r ɛ́ f j ʉw s
refuse	r ɪ f j ʉ́w z
regard	r ɪ g ɑ́ː d
region	r ɪ́j dʒ ə n
regional	r ɪ́j dʒ ə n ə l
register	r ɛ́ dʒ ɪ s t ə
regret	r ɪ g r ɛ́ t
regular	r ɛ́ g j ə l ə
regularly	r ɛ́ g j ə l ə l ɪj
regulation	r ɛ́ g j ə l ɛ́j ʃ ə n
reject	r ɪ dʒ ɛ́ k t
reject	r ɪ́j dʒ ɛ k t
relate	r ɪ l ɛ́j t
related	r ɪ l ɛ́j t ɪ d
relation	r ɪ l ɛ́j ʃ ə n
relationship	r ɪ l ɛ́j ʃ ə n ʃ ɪ p
relative	r ɛ́ l ə t ɪ v
relatively	r ɛ́ l ə t ɪ v l ɪj
relax	r ɪ l á k s
relaxed	r ɪ l á k s t
relaxing	r ɪ l á k s ɪ ŋ
release	r ɪ l ɪ́j s
relevant	r ɛ́ l ə v ə n t
reliable	r ɪ l ɑ́j ə b ə l
relief	r ɪ l ɪ́j f
religion	r ɪ l ɪ́ dʒ ə n
religious	r ɪ l ɪ́ dʒ ə s
rely	r ɪ l ɑ́j
remain	r ɪ m ɛ́j n
remark	r ɪ m ɑ́ː k
remember	r ɪ m ɛ́ m b ə
remind	r ɪ m ɑ́j n d
remote	r ɪ m ə́w t
remove	r ɪ m ʉ́w v
rent	r ɛ́ n t
repair	r ɪ p ɛ́ː
repeat	r ɪ p ɪ́j t
repeated	r ɪ p ɪ́j t ɪ d
replace	r ɪ p l ɛ́j s
reply	r ɪ p l ɑ́j
report	r ɪ p óː t
reporter	r ɪ p óː t ə
represent	r ɛ́ p r ə z ɛ́ n t
representative	r ɛ́ p r ɪ z ɛ́ n t ə t ɪ v
reputation	r ɛ́ p j ə t ɛ́j ʃ ə n
request	r ɪ k w ɛ́ s t
require	r ɪ k w ɑ́j ə
requirement	r ɪ k w ɑ́j ə m ə n t
rescue	r ɛ́ s k j ʉw
research	r ɪ s ə́ː tʃ
researcher	r ɪ s ə́ː tʃ ə
reservation	r ɛ́ z ə v ɛ́j ʃ ə n
reserve	r ɪ z ə́ː v
resident	r ɛ́ z ɪ d ə n t
resist	r ɪ z ɪ́ s t
resolve	r ɪ z ɔ́ l v
resort	r ɪ z óː t
resource	r ɪ z óː s
respect	r ɪ s p ɛ́ k t
respond	r ɪ s p ɔ́ n d
response	r ɪ s p ɔ́ n s
responsibility	r ɪ s p ɔ́ n s ə b ɪ́ l ə t ɪj
responsible	r ɪ s p ɔ́ n s ə b ə l
rest	r ɛ́ s t
restaurant	r ɛ́ s t r ɔ n t
result	r ɪ z ʌ́ l t
retain	r ɪ t ɛ́j n
retire	r ɪ t ɑ́j ə
retired	r ɪ t ɑ́j ə d
return	r ɪ t ə́ː n
reveal	r ɪ v ɪ́j l
review	r ɪ v j ʉ́w
revise	r ɪ v ɑ́j z
revolution	r ɛ́ v ə l ʉ́w ʃ ə n
reward	r ɪ w óː d
rhythm	r ɪ́ ð ə m
rice	r ɑ́j s
rich	r ɪ́ tʃ
rid	r ɪ́ d
ride	r ɑ́j d
right	r ɑ́j t
ring	r ɪ́ ŋ
rise	r ɑ́j z
risk	r ɪ́ s k
river	r ɪ́ v ə
road	r ə́w d
robot	r ə́w b ɔ t
rock	r ɔ́ k
role	r ə́w l
roll	r ə́w l
romantic	r əw m á n t ɪ k
roof	r ʉ́w f
room	r ʉ́w m
root	r ʉ́w t
rope	r ə́w p
rough	r ʌ́ f
round	r áw n d
route	r ʉ́w t
routine	r ʉw t ɪ́j n
row	r áw
row	r ə́w
royal	r ój ə l
rub	r ʌ́ b
rubber	r ʌ́ b ə
rubbish	r ʌ́ b ɪ ʃ
rude	r ʉ́w d
rugby	r ʌ́ g b ɪj
rule	r ʉ́w l
run	r ʌ́ n
runner	r ʌ́ n ə
running	r ʌ́ n ɪ ŋ
rural	r ɵ́ː r ə l
rush	r ʌ́ ʃ
sad	s á d
sadly	s á d l ɪj
safe	s ɛ́j f
safety	s ɛ́j f t ɪj
sail	s ɛ́j l
sailing	s ɛ́j l ɪ ŋ
sailor	s ɛ́j l ə
salad	s á l ə d
salary	s á l ə r ɪj
sale	s ɛ́j l
salt	s ɔ́ l t
same	s ɛ́j m
sample	s ɑ́ː m p ə l
sand	s á n d
sandwich	s á n w ɪ dʒ
satellite	s á t ə l ɑj t
satisfied	s á t ɪ s f ɑj d
satisfy	s á t ɪ s f ɑj
Saturday	s á t ə d ɛj
sauce	s óː s
save	s ɛ́j v
saving	s ɛ́j v ɪ ŋ
say	s ɛ́j
scale	s k ɛ́j l
scan	s k á n
scared	s k ɛ́ː d
scary	s k ɛ́ː r ɪj
scene	s ɪ́j n
schedule	ʃ ɛ́ dʒ ʉw l
scheme	s k ɪ́j m
school	s k ʉ́w l
science	s ɑ́j ə n s
scientific	s ɑ́j ə n t ɪ́ f ɪ k
scientist	s ɑ́j ə n t ɪ s t
score	s k óː
scream	s k r ɪ́j m
screen	s k r ɪ́j n
script	s k r ɪ́ p t
sculpture	s k ʌ́ l p tʃ ə
sea	s ɪ́j
search	s ə́ː tʃ
season	s ɪ́j z ə n
seat	s ɪ́j t
second	s ɛ́ k ə n d
second	s ɪ k ɔ́ n d
secondary	s ɛ́ k ə n d r ɪj
secondly	s ɛ́ k ə n d l ɪj
secret	s ɪ́j k r ə t
secretary	s ɛ́ k r ə t r ɪj
section	s ɛ́ k ʃ ə n
sector	s ɛ́ k t ə
secure	s ɪ k j ɵ́ː
security	s ɪ k j ɵ́ː r ə t ɪj
see	s ɪ́j
seed	s ɪ́j d
seek	s ɪ́j k
seem	s ɪ́j m
select	s ɪ l ɛ́ k t
selection	s ɪ l ɛ́ k ʃ ə n
self	s ɛ́ l f
sell	s ɛ́ l
send	s ɛ́ n d
senior	s ɪ́j n ɪj ə
sense	s ɛ́ n s
sensible	s ɛ́ n s ə b ə l
sensitive	s ɛ́ n s ə t ɪ v
sentence	s ɛ́ n t ə n s
separate	s ɛ́ p r ə t
separate	s ɛ́ p ə r ɛj t
September	s ɛ p t ɛ́ m b ə
sequence	s ɪ́j k w ə n s
series	s ɪ́ː r ɪj z
serious	s ɪ́ː r ɪj ə s
seriously	s ɪ́ː r ɪj ə s l ɪj
servant	s ə́ː v ə n t
serve	s ə́ː v
service	s ə́ː v ɪ s
session	s ɛ́ ʃ ə n
set	s ɛ́ t
setting	s ɛ́ t ɪ ŋ
settle	s ɛ́ t ə l
seven	s ɛ́ v ə n
seventeen	s ɛ́ v ə n t ɪ́j n
seventy	s ɛ́ v ə n t ɪj
several	s ɛ́ v r ə l
severe	s ɪ v ɪ́ː
sex	s ɛ́ k s
sexual	s ɛ́ k ʃ ʉw ə l
shade	ʃ ɛ́j d
shadow	ʃ á d əw
shake	ʃ ɛ́j k
shall	ʃ á l
shall	ʃ ə l
shallow	ʃ á l əw
shame	ʃ ɛ́j m
shape	ʃ ɛ́j p
share	ʃ ɛ́ː
sharp	ʃ ɑ́ː p
she	ʃ ɪ́j
sheep	ʃ ɪ́j p
sheet	ʃ ɪ́j t
shelf	ʃ ɛ́ l f
shell	ʃ ɛ́ l
shelter	ʃ ɛ́ l t ə
shift	ʃ ɪ́ f t
shine	ʃ ɑ́j n
shiny	ʃ ɑ́j n ɪj
ship	ʃ ɪ́ p
shirt	ʃ ə́ː t
shock	ʃ ɔ́ k
shocked	ʃ ɔ́ k t
shoe	ʃ ʉ́w
shoot	ʃ ʉ́w t
shooting	ʃ ʉ́w t ɪ ŋ
shop	ʃ ɔ́ p
shopping	ʃ ɔ́ p ɪ ŋ
short	ʃ óː t
shot	ʃ ɔ́ t
should	ʃ ɵ́ d
should	ʃ ə d
shoulder	ʃ ə́w l d ə
shout	ʃ áw t
show	ʃ ə́w
shower	ʃ áw ə
shut	ʃ ʌ́ t
shy	ʃ ɑ́j
sick	s ɪ́ k
side	s ɑ́j d
sight	s ɑ́j t
sign	s ɑ́j n
signal	s ɪ́ g n ə l
significant	s ɪ g n ɪ́ f ɪ k ə n t
significantly	s ɪ g n ɪ́ f ɪ k ə n t l ɪj
silence	s ɑ́j l ə n s
silent	s ɑ́j l ə n t
silk	s ɪ́ l k
silly	s ɪ́ l ɪj
silver	s ɪ́ l v ə
similar	s ɪ́ m ə l ə
similarity	s ɪ́ m ə l á r ə t ɪj
similarly	s ɪ́ m ə l ə l ɪj
simple	s ɪ́ m p ə l
simply	s ɪ́ m p l ɪj
since	s ɪ́ n s
sincere	s ɪ n s ɪ́ː
sing	s ɪ́ ŋ
singer	s ɪ́ ŋ ə
singing	s ɪ́ ŋ ɪ ŋ
single	s ɪ́ ŋ g ə l
sink	s ɪ́ ŋ k
sir	s ə́ː
sister	s ɪ́ s t ə
sit	s ɪ́ t
site	s ɑ́j t
situation	s ɪ́ tʃ ʉw ɛ́j ʃ ə n
six	s ɪ́ k s
sixteen	s ɪ́ k s t ɪ́j n
sixty	s ɪ́ k s t ɪj
size	s ɑ́j z
ski	s k ɪ́j
skiing	s k ɪ́j ɪ ŋ
skill	s k ɪ́ l
skin	s k ɪ́ n
skirt	s k ə́ː t
sky	s k ɑ́j
slave	s l ɛ́j v
sleep	s l ɪ́j p
slice	s l ɑ́j s
slide	s l ɑ́j d
slight	s l ɑ́j t
slightly	s l ɑ́j t l ɪj
slip	s l ɪ́ p
slope	s l ə́w p
slow	s l ə́w
slowly	s l ə́w l ɪj
small	s m óː l
smart	s m ɑ́ː t
smell	s m ɛ́ l
smile	s m ɑ́j l
smoke	s m ə́w k
smoking	s m ə́w k ɪ ŋ
smooth	s m ʉ́w ð
snake	s n ɛ́j k
snow	s n ə́w
so	s ə́w
soap	s ə́w p
soccer	s ɔ́ k ə
social	s ə́w ʃ ə l
society	s ə s ɑ́j ə t ɪj
sock	s ɔ́ k
soft	s ɔ́ f t
software	s ɔ́ f t w ɛː
soil	s ój l
solar	s ə́w l ə
soldier	s ə́w l dʒ ə
solid	s ɔ́ l ɪ d
solution	s ə l ʉ́w ʃ ə n
solve	s ɔ́ l v
some	s ə m
some	s ʌ́ m
somebody	s ʌ́ m b ə d ɪj
someone	s ʌ́ m w ʌ n
something	s ʌ́ m θ ɪ ŋ
sometimes	s ʌ́ m t ɑj m z
somewhat	s ʌ́ m w ɔ t
somewhere	s ʌ́ m w ɛː
son	s ʌ́ n
song	s ɔ́ ŋ
soon	s ʉ́w n
sorry	s ɔ́ r ɪj
sort	s óː t
soul	s ə́w l
sound	s áw n d
soup	s ʉ́w p
source	s óː s
south	s áw θ
southern	s ʌ́ ð ə n
space	s p ɛ́j s
speak	s p ɪ́j k
speaker	s p ɪ́j k ə
special	s p ɛ́ ʃ ə l
specialist	s p ɛ́ ʃ ə l ɪ s t
species	s p ɪ́j ʃ ɪj z
specific	s p ə s ɪ́ f ɪ k
specifically	s p ə s ɪ́ f ɪ k l ɪj
speech	s p ɪ́j tʃ
speed	s p ɪ́j d
spell	s p ɛ́ l
spelling	s p ɛ́ l ɪ ŋ
spend	s p ɛ́ n d
spending	s p ɛ́ n d ɪ ŋ
spicy	s p ɑ́j s ɪj
spider	s p ɑ́j d ə
spirit	s p ɪ́ r ɪ t
spiritual	s p ɪ́ r ɪ tʃ ʉw ə l
split	s p l ɪ́ t
spoken	s p ə́w k ə n
sponsor	s p ɔ́ n s ə
spoon	s p ʉ́w n
sport	s p óː t
spot	s p ɔ́ t
spread	s p r ɛ́ d
spring	s p r ɪ́ ŋ
square	s k w ɛ́ː
stable	s t ɛ́j b ə l
stadium	s t ɛ́j d ɪj ə m
staff	s t ɑ́ː f
stage	s t ɛ́j dʒ
stair	s t ɛ́ː
stamp	s t á m p
stand	s t á n d
standard	s t á n d ə d
star	s t ɑ́ː
stare	s t ɛ́ː
start	s t ɑ́ː t
state	s t ɛ́j t
statement	s t ɛ́j t m ə n t
station	s t ɛ́j ʃ ə n
statistic	s t ə t ɪ́ s t ɪ k
statue	s t á tʃ ʉw
status	s t ɛ́j t ə s
stay	s t ɛ́j
steady	s t ɛ́ d ɪj
steal	s t ɪ́j l
steel	s t ɪ́j l
steep	s t ɪ́j p
step	s t ɛ́ p
stick	s t ɪ́ k
sticky	s t ɪ́ k ɪj
stiff	s t ɪ́ f
still	s t ɪ́ l
stock	s t ɔ́ k
stomach	s t ʌ́ m ə k
stone	s t ə́w n
stop	s t ɔ́ p
store	s t óː
storm	s t óː m
story	s t óː r ɪj
straight	s t r ɛ́j t
strange	s t r ɛ́j n dʒ
stranger	s t r ɛ́j n dʒ ə
strategy	s t r á t ə dʒ ɪj
stream	s t r ɪ́j m
street	s t r ɪ́j t
strength	s t r ɛ́ ŋ k θ
stress	s t r ɛ́ s
stretch	s t r ɛ́ tʃ
strict	s t r ɪ́ k t
strike	s t r ɑ́j k
string	s t r ɪ́ ŋ
strong	s t r ɔ́ ŋ
strongly	s t r ɔ́ ŋ l ɪj
structure	s t r ʌ́ k tʃ ə
struggle	s t r ʌ́ g ə l
student	s tʃ ʉ́w d ə n t
studio	s tʃ ʉ́w d ɪj əw
study	s t ʌ́ d ɪj
stuff	s t ʌ́ f
stupid	s tʃ ʉ́w p ɪ d
style	s t ɑ́j l
subject	s ə b dʒ ɛ́ k t
subject	s ʌ́ b dʒ ɛ k t
submit	s ə b m ɪ́ t
substance	s ʌ́ b s t ə n s
succeed	s ə k s ɪ́j d
success	s ə k s ɛ́ s
successful	s ə k s ɛ́ s f ə l
successfully	s ə k s ɛ́ s f ə l ɪj
such	s ʌ́ tʃ
sudden	s ʌ́ d ə n
suddenly	s ʌ́ d ə n l ɪj
suffer	s ʌ́ f ə
sugar	ʃ ɵ́ g ə
suggest	s ə dʒ ɛ́ s t
suggestion	s ə dʒ ɛ́ s tʃ ə n
suit	s ʉ́w t
suitable	s ʉ́w t ə b ə l
sum	s ʌ́ m
summarize	s ʌ́ m ə r ɑj z
summary	s ʌ́ m ə r ɪj
summer	s ʌ́ m ə
sun	s ʌ́ n
Sunday	s ʌ́ n d ɛj
supermarket	s ʉ́w p ə m ɑː k ɪ t
supply	s ə p l ɑ́j
support	s ə p óː t
supporter	s ə p óː t ə
suppose	s ə p ə́w z
sure	ʃ óː
surely	ʃ óː l ɪj
surface	s ə́ː f ɪ s
surgery	s ə́ː dʒ ə r ɪj
surprise	s ə p r ɑ́j z
surprised	s ə p r ɑ́j z d
surprising	s ə p r ɑ́j z ɪ ŋ
surround	s ə r áw n d
surrounding	s ə r áw n d ɪ ŋ
survey	s ə v ɛ́j
survey	s ə́ː v ɛj
survive	s ə v ɑ́j v
suspect	s ə s p ɛ́ k t
suspect	s ʌ́ s p ɛ k t
swear	s w ɛ́ː
sweater	s w ɛ́ t ə
sweep	s w ɪ́j p
sweet	s w ɪ́j t
swim	s w ɪ́ m
swimming	s w ɪ́ m ɪ ŋ
switch	s w ɪ́ tʃ
symbol	s ɪ́ m b ə l
sympathy	s ɪ́ m p ə θ ɪj
symptom	s ɪ́ m p t ə m
system	s ɪ́ s t ə m
T-shirt	t ɪ́j ʃ əː t
table	t ɛ́j b ə l
tablet	t á b l ə t
tail	t ɛ́j l
take	t ɛ́j k
tale	t ɛ́j l
talent	t á l ə n t
talented	t á l ə n t ɪ d
talk	t óː k
tall	t óː l
tank	t á ŋ k
tape	t ɛ́j p
target	t ɑ́ː g ɪ t
task	t ɑ́ː s k
taste	t ɛ́j s t
tax	t á k s
taxi	t á k s ɪj
tea	t ɪ́j
teach	t ɪ́j tʃ
teacher	t ɪ́j tʃ ə
teaching	t ɪ́j tʃ ɪ ŋ
team	t ɪ́j m
tear	t ɛ́ː
tear	t ɪ́ː
technical	t ɛ́ k n ɪ k ə l
technique	t ɛ k n ɪ́j k
technology	t ɛ k n ɔ́ l ə dʒ ɪj
teenage	t ɪ́j n ɛj dʒ
teenager	t ɪ́j n ɛj dʒ ə
telephone	t ɛ́ l ɪ f əw n
television	t ɛ́ l ɪ v ɪ ʒ ə n
tell	t ɛ́ l
temperature	t ɛ́ m p r ə tʃ ə
temporary	t ɛ́ m p r ə r ɪj
ten	t ɛ́ n
tend	t ɛ́ n d
tennis	t ɛ́ n ɪ s
tent	t ɛ́ n t
term	t ə́ː m
terrible	t ɛ́ r ə b ə l
test	t ɛ́ s t
text	t ɛ́ k s t
than	ð á n
than	ð ə n
thank	θ á ŋ k
thanks	θ á ŋ k s
that	ð á t
that	ð ə t
the	ð ɪ́j
the	ð ə
theatre	θ ɪ́j ə t ə
their	ð ɛ́ː
theirs	ð ɛ́ː z
them	ð ɛ́ m
them	ð ə m
theme	θ ɪ́j m
themselves	ð ə m s ɛ́ l v z
then	ð ɛ́ n
theory	θ ɪ́j ə r ɪj
therapy	θ ɛ́ r ə p ɪj
there	ð ɛ́ː
there	ð ə
therefore	ð ɛ́ː f oː
they	ð ɛ́j
thick	θ ɪ́ k
thief	θ ɪ́j f
thin	θ ɪ́ n
thing	θ ɪ́ ŋ
think	θ ɪ́ ŋ k
thinking	θ ɪ́ ŋ k ɪ ŋ
third	θ ə́ː d
thirsty	θ ə́ː s t ɪj
thirteen	θ ə́ː t ɪ́j n
thirty	θ ə́ː t ɪj
this	ð ɪ́ s
though	ð ə́w
thought	θ óː t
thousand	θ áw z ə n d
threat	θ r ɛ́ t
threaten	θ r ɛ́ t ə n
three	θ r ɪ́j
throat	θ r ə́w t
through	θ r ʉ́w
throughout	θ r ʉw áw t
throw	θ r ə́w
Thursday	θ ə́ː z d ɛj
thus	ð ʌ́ s
ticket	t ɪ́ k ɪ t
tidy	t ɑ́j d ɪj
tie	t ɑ́j
tight	t ɑ́j t
till	t ɪ́ l
time	t ɑ́j m
tin	t ɪ́ n
tiny	t ɑ́j n ɪj
tip	t ɪ́ p
tired	t ɑ́j ə d
title	t ɑ́j t ə l
to	t ʉ́w
to	t ə
today	t ə d ɛ́j
toe	t ə́w
together	t ə g ɛ́ ð ə
toilet	t ój l ə t
tomato	t ə m ɑ́ː t əw
tomorrow	t ə m ɔ́ r əw
tone	t ə́w n
tongue	t ʌ́ ŋ
tonight	t ə n ɑ́j t
too	t ʉ́w
tool	t ʉ́w l
tooth	t ʉ́w θ
top	t ɔ́ p
topic	t ɔ́ p ɪ k
total	t ə́w t ə l
totally	t ə́w t ə l ɪj
touch	t ʌ́ tʃ
tough	t ʌ́ f
tour	t óː
tourism	t óː r ɪ z ə m
tourist	t óː r ɪ s t
towards	t ə w óː d z
towel	t áw ə l
tower	t áw ə
town	t áw n
toy	t ój
track	t r á k
trade	t r ɛ́j d
tradition	t r ə d ɪ́ ʃ ə n
traditional	t r ə d ɪ́ ʃ ə n ə l
traffic	t r á f ɪ k
train	t r ɛ́j n
trainer	t r ɛ́j n ə
training	t r ɛ́j n ɪ ŋ
transfer	t r a n s f ə́ː
transfer	t r á n s f əː
transform	t r a n s f óː m
transition	t r a n z ɪ́ ʃ ə n
translate	t r a n z l ɛ́j t
translation	t r a n z l ɛ́j ʃ ə n
transport	t r a n s p óː t
transport	t r á n s p oː t
travel	t r á v ə l
traveller	t r á v l ə
treat	t r ɪ́j t
treatment	t r ɪ́j t m ə n t
tree	t r ɪ́j
trend	t r ɛ́ n d
trial	t r ɑ́j ə l
trick	t r ɪ́ k
trip	t r ɪ́ p
tropical	t r ɔ́ p ɪ k ə l
trouble	t r ʌ́ b ə l
trousers	t r áw z ə z
truck	t r ʌ́ k
true	t r ʉ́w
truly	t r ʉ́w l ɪj
trust	t r ʌ́ s t
truth	t r ʉ́w θ
try	t r ɑ́j
tube	tʃ ʉ́w b
Tuesday	tʃ ʉ́w z d ɛj
tune	tʃ ʉ́w n
tunnel	t ʌ́ n ə l
turn	t ə́ː n
TV	t ɪ́j v ɪ́j
twelve	t w ɛ́ l v
twenty	t w ɛ́ n t ɪj
twice	t w ɑ́j s
twin	t w ɪ́ n
two	t ʉ́w
type	t ɑ́j p
typical	t ɪ́ p ɪ k ə l
typically	t ɪ́ p ɪ k l ɪj
tyre	t ɑ́j ə
ugly	ʌ́ g l ɪj
ultimately	ʌ́ l t ɪ m ə t l ɪj
umbrella	ʌ m b r ɛ́ l ə
unable	ʌ́ n ɛ́j b ə l
uncle	ʌ́ ŋ k ə l
uncomfortable	ʌ́ n k ʌ́ m f t ə b ə l
unconscious	ʌ́ n k ɔ́ n ʃ ə s
under	ʌ́ n d ə
underground	ʌ́ n d ə g r aw n d
understand	ʌ́ n d ə s t á n d
understanding	ʌ́ n d ə s t á n d ɪ ŋ
underwear	ʌ́ n d ə w ɛː
unemployed	ʌ́ n ɪ m p l ój d
unemployment	ʌ́ n ɪ m p l ój m ə n t
unexpected	ʌ́ n ɪ k s p ɛ́ k t ɪ d
unfair	ʌ́ n f ɛ́ː
unfortunately	ʌ́ n f óː tʃ ə n ə t l ɪj
unhappy	ʌ́ n h á p ɪj
uniform	j ʉ́w n ɪ f oː m
union	j ʉ́w n ɪj ə n
unique	j ʉw n ɪ́j k
unit	j ʉ́w n ɪ t
united	j ʉw n ɑ́j t ɪ d
universe	j ʉ́w n ɪ v əː s
university	j ʉ́w n ɪ v ə́ː s ə t ɪj
unknown	ʌ́ n n ə́w n
unless	ə n l ɛ́ s
unlike	ʌ́ n l ɑ́j k
unlikely	ʌ́ n l ɑ́j k l ɪj
unnecessary	ʌ́ n n ɛ́ s ə s ɛ r ɪj
unpleasant	ʌ́ n p l ɛ́ z ə n t
until	ʌ́ n t ɪ́ l
unusual	ʌ n j ʉ́w ʒ ʉw ə l
up	ʌ́ p
update	ʌ́ p d ɛ́j t
update	ʌ́ p d ɛj t
upon	ə p ɔ́ n
upper	ʌ́ p ə
upset	ʌ́ p s ɛ́ t
upset	ʌ́ p s ɛ t
upstairs	ʌ́ p s t ɛ́ː z
upwards	ʌ́ p w ə d z
urban	ə́ː b ə n
urge	ə́ː dʒ
us	ə s
us	ʌ́ s
use	j ʉ́w s
use	j ʉ́w z
used	j ʉ́w s t
used	j ʉ́w z d
useful	j ʉ́w s f ə l
user	j ʉ́w z ə
usual	j ʉ́w ʒ ʉw ə l
usually	j ʉ́w ʒ ə l ɪj
vacation	v ɛj k ɛ́j ʃ ə n
valley	v á l ɪj
valuable	v á l j ə b ə l
value	v á l j ʉw
van	v á n
variety	v ə r ɑ́j ə t ɪj
various	v ɛ́ː r ɪj ə s
vary	v ɛ́ː r ɪj
vast	v ɑ́ː s t
vegetable	v ɛ́ dʒ t ə b ə l
vehicle	v ɪ́j ɪ k ə l
venue	v ɛ́ n j ʉw
version	v ə́ː ʒ ə n
very	v ɛ́ r ɪj
via	v ɑ́j ə
victim	v ɪ́ k t ɪ m
victory	v ɪ́ k t ə r ɪj
video	v ɪ́ d ɪj əw
view	v j ʉ́w
viewer	v j ʉ́w ə
village	v ɪ́ l ɪ dʒ
violence	v ɑ́j ə l ə n s
violent	v ɑ́j ə l ə n t
virtual	v ə́ː tʃ ʉw ə l
virus	v ɑ́j r ə s
vision	v ɪ́ ʒ ə n
visit	v ɪ́ z ɪ t
visitor	v ɪ́ z ɪ t ə
visual	v ɪ́ ʒ ʉw ə l
vital	v ɑ́j t ə l
vitamin	v ɪ́ t ə m ɪ n
voice	v ój s
volume	v ɔ́ l j ʉw m
volunteer	v ɔ́ l ə n t ɪ́ː
vote	v ə́w t
wage	w ɛ́j dʒ
wait	w ɛ́j t
waiter	w ɛ́j t ə
wake	w ɛ́j k
walk	w óː k
wall	w óː l
want	w ɔ́ n t
war	w óː
warm	w óː m
warn	w óː n
warning	w óː n ɪ ŋ
wash	w ɔ́ ʃ
washing	w ɔ́ ʃ ɪ ŋ
waste	w ɛ́j s t
watch	w ɔ́ tʃ
water	w óː t ə
wave	w ɛ́j v
way	w ɛ́j
we	w ɪ́j
weak	w ɪ́j k
weakness	w ɪ́j k n ə s
wealth	w ɛ́ l θ
wealthy	w ɛ́ l θ ɪj
weapon	w ɛ́ p ə n
wear	w ɛ́ː
weather	w ɛ́ ð ə
web	w ɛ́ b
website	w ɛ́ b s ɑj t
wedding	w ɛ́ d ɪ ŋ
Wednesday	w ɛ́ n z d ɛj
week	w ɪ́j k
weekend	w ɪj k ɛ́ n d
weigh	w ɛ́j
weight	w ɛ́j t
welcome	w ɛ́ l k ə m
well	w ɛ́ l
west	w ɛ́ s t
western	w ɛ́ s t ə n
wet	w ɛ́ t
what	w ɔ́ t
whatever	w ɔ t ɛ́ v ə
wheel	w ɪ́j l
when	w ɛ́ n
whenever	w ɛ n ɛ́ v ə
where	w ɛ́ː
whereas	w ɛ́ː r á z
wherever	w ɛ́ː r ɛ́ v ə
whether	w ɛ́ ð ə
which	w ɪ́ tʃ
while	w ɑ́j l
whisper	w ɪ́ s p ə
white	w ɑ́j t
who	h ʉ́w
whole	h ə́w l
whom	h ʉ́w m
whose	h ʉ́w z
why	w ɑ́j
wide	w ɑ́j d
widely	w ɑ́j d l ɪj
wife	w ɑ́j f
wild	w ɑ́j l d
wildlife	w ɑ́j l d l ɑj f
will	w ɪ́ l
will	w ɪ l
willing	w ɪ́ l ɪ ŋ
win	w ɪ́ n
wind	w ɑ́j n d
wind	w ɪ́ n d
window	w ɪ́ n d əw
wine	w ɑ́j n
wing	w ɪ́ ŋ
winner	w ɪ́ n ə
winter	w ɪ́ n t ə
wire	w ɑ́j ə
wise	w ɑ́j z
wish	w ɪ́ ʃ
with	w ɪ ð
with	w ɪ́ ð
within	w ɪ ð ɪ́ n
without	w ɪ ð áw t
witness	w ɪ́ t n ə s
woman	w ɵ́ m ə n
wonder	w ʌ́ n d ə
wonderful	w ʌ́ n d ə f ə l
wood	w ɵ́ d
wooden	w ɵ́ d ə n
wool	w ɵ́ l
word	w ə́ː d
work	w ə́ː k
worker	w ə́ː k ə
working	w ə́ː k ɪ ŋ
world	w ə́ː l d
worldwide	w ə́ː l d w ɑj d
worried	w ʌ́ r ɪj d
worry	w ʌ́ r ɪj
worse	w ə́ː s
worst	w ə́ː s t
worth	w ə́ː θ
would	w ɵ́ d
would	w ə d
wound	w áw n d
wound	w ʉ́w n d
wow	w áw
wrap	r á p
write	r ɑ́j t
writer	r ɑ́j t ə
writing	r ɑ́j t ɪ ŋ
written	r ɪ́ t ə n
wrong	r ɔ́ ŋ
yard	j ɑ́ː d
yeah	j ɛ́
year	j ɪ́ː
yellow	j ɛ́ l əw
yes	j ɛ́ s
yesterday	j ɛ́ s t ə d ɛj
yet	j ɛ́ t
you	j ʉ́w
young	j ʌ́ ŋ
your	j óː
yours	j óː z
yourself	j oː s ɛ́ l f
youth	j ʉ́w θ
zero	z ɪ́ː r əw
zone	z ə́w n
